a	IN
abadía	NN
abajo	RB
abalorio	NN
abandonar	VB
abastecer	VB
abatida	JJ
abatido	JJ
abatir	VB
abdicar	VB
abdomen	NN
abeja	NN
abeto	NN
abogada	NN
abogado	NN
abogar	VB
abominación	NN
abonarse	VB
abono	NN
abrazadera	NN
abrazarse	VB
abrelatas	NN
abreviatura	NN
abrigo	NN
abril	NN
abrir	VB
abrochar	VB
abrocharse	VB
absoluta	JJ
absolutamente	RB
absoluto	JJ
absorber	VB
abstenerse	VB
abstracta	JJ
abstracto	JJ
absurda	JJ
absurdo	JJ
abuela	NN
abuelo	NN
abuelos	NNS
abundante	JJ
aburrida	JJ
aburridísima	JJ
aburridísimo	JJ
aburrido	JJ
aburrir	VB
aburrirse	VB
acabar	VB
academia	NN
académica	JJ
académico	JJ
acampar	VB
acantilado	NN
acariciar	VB
acceso	NN
accesorio	NN
accidente	NN
acción	NN
aceite	NN
aceituna	NN
aceleración	NN
acelerada	JJ
acelerado	JJ
acelerar	VB
acelga	NN
acento	NN
acentuar	VB
aceptable	JJ
aceptar	VB
acera	NN
acercarse	VB
acero	NN
acertar	VB
acertijo	NN
ácida	JJ
ácido	JJ
aclamación	NN
aclamar	VB
aclarar	VB
acne	NN
acoger	VB
acolchar	VB
acomodada	JJ
acomodado	JJ
acomodador	NN
acomodadora	NN
acondicionador	NN
acontecimiento	NN
acorazado	NN
acordar	VB
acorde	NN
acordeón	NN
acostarse	VB
acre	JJ
acreedor	JJ
acreedora	JJ
actinio	NN
actitud	NN
activamente	RB
activar	VB
actividad	NN
actividades	NNS
actor	NN
actriz	NN
actuación	NN
actual	JJ
actualizar	VB
actualmente	RB
actuar	VB
acuarela	NN
acuarelas	NNS
acuario	NN
acuática	JJ
acuático	JJ
acuerdo	NN
acumular	VB
acupuntura	NN
acusar	VB
adaptar	VB
adecuada	JJ
adecuado	JJ
adelantar	VB
adelante	RB
ademán	NN
además	RB
adentro	RB
adherir	VB
adhesiva	JJ
adhesivo	JJ
adición	NN
adicional	JJ
adivina	NN
adivinar	VB
adivino	NN
administrador	NN
administradora	NN
administrar	VB
administrativa	JJ
administrativo	JJ
admirar	VB
adobo	NN
adónde	WRB
adoptar	VB
adoración	NN
adorar	VB
adornar	VB
adorno	NN
adquirir	VB
adscribir	VB
aduana	NN
aduanera	NN
aduanero	NN
adulta	NN
adulto	NN
aeropuerto	NN
afable	JJ
afán	NN
afectar	VB
afectiva	JJ
afectivo	JJ
afeitarse	VB
afeminada	JJ
afeminado	JJ
Afganistán	NNP
afirmación	NN
afirmar	VB
afortunada	JJ
afortunado	JJ
África	NNP
africana	JJ
africano	JJ
afuera	RB
afueras	NNS
agacharse	VB
agarrar	VB
agencia	NN
agente	NN
agobiar	VB
agosto	NN
agotada	JJ
agotado	JJ
agotar	VB
agradar	VB
agradecer	VB
agradecida	JJ
agradecido	JJ
agraria	JJ
agrario	JJ
agregar	VB
agria	JJ
agricultura	NN
agrio	JJ
agua	NN
aguacate	NN
aguada	JJ
aguado	JJ
aguamarina	NN
aguda	JJ
agudo	JJ
aguila	NN
aguileña	NN
aguja	NN
agujero	NN
ahí	RB
ahijada	NN
ahijado	NN
ahogar	VB
ahorrar	VB
ahuyentar	VB
airada	JJ
airado	JJ
aire	NN
aislada	JJ
aislado	JJ
aislamiento	NN
ajedrez	NN
ajo	NN
ajuste	NN
alabanza	NN
alabar	VB
alacrán	NN
alambre	NN
alargada	JJ
alargado	JJ
alargar	VB
alarido	NN
alarma	NN
albahaca	NN
albañil	NN
albaricoque	NN
albornoz	NN
álbum	NN
alcachofa	NN
alcalde	NN
alcaldesa	NN
alcantarilla	NN
alcanzar	VB
alcázar	NN
alce	NN
alcohol	NN
aldea	NN
alegrarse	VB
alegre	JJ
alegría	NN
alejar	VB
alemán	JJ
alemana	JJ
Alemania	NNP
alentar	VB
alergia	NN
alérgica	JJ
alérgico	JJ
alerta	NN
alertar	VB
aleta	NN
aletear	VB
alfabeto	NN
alfanje	NN
alfiler	NN
alfombra	NN
álgebra	NN
algodón	NN
alimentación	NN
alimentar	VB
alistar	VB
aliviar	VB
allí	RB
alma	NN
almacén	NN
almanaque	NN
almeja	NN
almidón	NN
almohada	NN
almohadilla	NN
almohadón	NN
almorzar	VB
almuerzo	NN
alocada	JJ
alocado	JJ
alojamiento	NN
alojar	VB
alpaca	NN
alquilar	VB
alquitrán	NN
alrededor	RB
alta	JJ
altar	NN
altavoz	NN
alterar	VB
alternativa	JJ
alternativo	JJ
alto	JJ
altura	NN
aluminio	NN
ama	NN
amabilidad	NN
amable	JJ
amaestrar	VB
amamantar	VB
amanecer	NN
amarga	JJ
amargo	JJ
amarilla	JJ
amarillo	JJ
amarrar	VB
amatista	NN
Amazonia	NNP
ambas	JJ
ambiciosa	JJ
ambicioso	JJ
ambidextra	JJ
ambidextro	JJ
ambiente	NN
ambigua	JJ
ambigüedad	NN
ambiguo	JJ
ambos	JJ
ambulancia	NN
ambulante	JJ
amenaza	NN
amenazante	JJ
amenazar	VB
América	NNP
amiga	NN
amígdala	NN
amigdalitis	NN
amigo	NN
amistad	NN
amo	NN
amontonar	VB
amor	NN
amorfa	JJ
amorfo	JJ
amortiguador	NN
amotinamiento	NN
amotinarse	VB
amplia	JJ
ampliar	VB
amplificación	NN
amplificador	NN
amplio	JJ
ampolleta	NN
amuleto	NN
añadidura	RB
añadir	VB
análisis	NN
analizar	VB
anarquía	NN
anatomía	NN
ancha	JJ
ancho	JJ
anciana	JJ
anciano	JJ
ancla	NN
andar	VB
aneurisma	NN
anfitrión	NN
anfitriona	NN
ángel	NN
ángulo	NN
angustia	NN
anhelar	VB
anillo	NN
animación	NN
animada	JJ
animado	JJ
animador	NN
animadora	NN
animal	NN
animales	NNS
animar	VB
aniquilar	VB
aniversario	NN
ano	NN
año	NN
anoche	RB
anochecer	NN
anolar	VB
anoréxica	JJ
anoréxico	JJ
anormal	JJ
antártica	JJ
antártico	JJ
Antártida	NNP
antebrazo	NN
antena	NN
anteojos	NNS
antepasadas	NNS
antepasados	NNS
anteproyecto	NN
anterior	JJ
anteriormente	RB
antes	RB
antialérgica	JJ
antialérgico	JJ
antibiótico	NN
anticipar	VB
anticuario	NN
antidepresivo	NN
antigua	JJ
antiguo	JJ
antihistamínico	NN
antílope	NN
antimonio	NN
antipática	JJ
antipático	JJ
antorcha	NN
antropoide	JJ
antropóloga	NN
antropología	NN
antropólogo	NN
anuario	NN
anular	VB
anunciar	VB
anuncio	NN
apagada	JJ
apagado	JJ
apagar	VB
aparato	NN
aparcamiento	NN
aparcar	VB
aparecer	VB
aparición	NN
apariencia	NN
apartamento	NN
apasionada	JJ
apasionado	JJ
apellido	NN
apenas	RB
apéndice	NN
apendicitis	NN
aperitivo	NN
apestar	VB
apio	NN
aplastante	JJ
aplastar	VB
aplaudir	VB
aplauso	NN
aplicar	VB
aporrear	VB
apostar	VB
apóstol	NN
apóstrofo	NN
apoyar	VB
apoyarse	VB
apoyo	NN
apreciar	VB
aprender	VB
aprendizaje	NN
apresurar	VB
apretada	JJ
apretado	JJ
apretar	VB
aprobación	NN
aprobar	VB
apropiada	JJ
apropiado	JJ
aprovechar	VB
aproximadamente	RB
apuesta	NN
apuñalar	VB
apuntalar	VB
aquí	RB
árabe	JJ
araña	NN
arañar	VB
arañazo	NN
arándano	NN
árbitra	NN
arbitraria	JJ
arbitrario	JJ
árbitro	NN
árbol	NN
arbusto	NN
arcana	JJ
arcano	JJ
arce	NN
archivar	VB
archivo	NN
arcilla	NN
arco	NN
ardilla	NN
área	NN
arena	NN
arete	NN
Argentina	NNP
argentina	JJ
Argentina	NNP
argentino	JJ
argón	NN
argumento	NN
aries	NN
arma	NN
armadura	NN
armario	NN
armonía	NN
armónica	NN
aro	NN
arpa	NN
arqueóloga	NN
arqueología	NN
arqueólogo	NN
arquera	NN
arquero	NN
arquetipo	NN
arquitecto	NN
arquitectura	NN
arrancar	VB
arrastrar	VB
arrastrarse	VB
arrecife	NN
arreglar	VB
arremeter	VB
arrepentimiento	NN
arrepentirse	VB
arrestar	VB
arriba	RB
arriesgar	VB
arroba	NN
arrodillarse	VB
arrogancia	NN
arroyo	NN
arroz	NN
arruga	NN
arrugar	VB
arrugarse	VB
arsénico	NN
arte	NN
arteria	NN
artes	NNS
artesanal	JJ
artesanía	NN
ártica	JJ
ártico	JJ
articulación	NN
artículo	NN
artista	NN
artistica	JJ
artístico	JJ
artritis	NN
artrópodo	NN
asador	NN
asamblea	NN
asbesto	NN
ascendencia	NN
ascender	VB
ascenso	NN
ascensor	NN
asesina	NN
asesinato	NN
asesino	NN
asfixiar	VB
así	RB
Asia	NNP
asiático	JJ
asiento	NN
asilo	NN
asistente	NN
asistir a	VB
asno	NN
asociación	NN
asomar	VB
asombrar	VB
asombrosa	JJ
asombroso	JJ
aspecto	NN
aspiradora	NN
aspirina	NN
asta	NN
ástaco	NN
ástato	NN
asterisco	NN
astilla	NN
astro	NN
astrología	NN
astronauta	NN
astrónoma	NN
astronomía	NN
astrónomo	NN
asumir	VB
asunto	NN
asustada	JJ
asustadiza	JJ
asustadizo	JJ
asustado	JJ
asustar	VB
atacar	VB
ataque	NN
atar	VB
atardecer	NN
atascar	VB
atasco	NN
atea	JJ
ateísmo	NN
atender	VB
atenta	JJ
atentado	NN
atento	JJ
ateo	JJ
aterrizar	VB
atestiguar	VB
atlántico	JJ
atletismo	NN
atmósfera	NN
atómica	JJ
atómico	JJ
atomizador	NN
átomo	NN
atractiva	JJ
atractivo	JJ
atraer	VB
atrapar	VB
atravesar	VB
atreverse	VB
atrevida	JJ
atrevido	JJ
atribuir	VB
atropellada	JJ
atropellado	JJ
atropellar	VB
atroz	JJ
atún	NN
auditorio	NN
auge	NN
aumentar	VB
aumento	NN
aún	RB
aura	NN
auricular	NN
auriculares	NNS
ausencia	NN
Australia	NNP
australiana	JJ
australiano	JJ
autobiografía	NN
autobús	NN
autodefensa	NN
autoestima	NN
autografiar	VB
autógrafo	NN
autómata	NN
automática	JJ
automático	JJ
autonomía	NN
autopista	NN
autopsia	NN
autoridad	NN
autorretrato	NN
avalancha	NN
avance	NN
avanzada	JJ
avanzado	JJ
avanzar	VB
avenida	NN
avergonzada	JJ
avergonzado	JJ
avergonzar	VB
averiguar	VB
aves	NN
avestruz	NN
aviador	NN
aviadora	NN
avión	NN
axila	NN
ayer	RB
ayuda	NN
ayudante	NN
ayudar	VB
azotar	VB
azúcar	NN
azufre	NN
azúl	JJ
azulejo	NN
babuino	NN
bacalao	NN

bacterium	NN
bádminton	NN
bailar	VB
bailarín	NN
bailarina	NN
baile	NN
baja	JJ
bajar	VB
bajo	JJ
bala	NN
balanza	NN
balbucear	VB
balcón	NN
balde	NN
ballena	NN
balompié	NN
balón	NN
baloncesto	NN
balonmano	NN
balsa	NN
bálsamo	NN
baluarte	NN
bambú	NN
bañador	NN
bañar	VB
bañarse	VB
banca	NN
banco	NN
banda	NN
bandana	NN
bandeja	NN
bandera	NN
banjo	NN
baño	NN
banquera	NN
banquero	NN
banquete	NN
baranda	NN
barandilla	NN
barata	JJ
barato	JJ
barba	NN
barbacoa	NN
barco	NN
bario	NN
barítono	NN
barra	NN
barrer	VB
barriga	NN
barrio	NN
barro	NN
barroca	JJ
barroco	JJ
base	NN
básica	JJ
básicamente	RB
básico	JJ
básquetbol	NN
basquetbolista	NN
bastante	RB
bastar	VB
bastión	NN
basura	NN
bata	NN
batalla	NN
batata	NN
batazo	NN
bate	NN
bateador	NN
batería	NN
baterista	NN
batido	NN
batir	VB
Batman	NN
baúl	NN
bautizar	VB
bayoneta	NN
bazo	NN
bazofia	NN
bazuca	NN
bebé	NN
bebedero	NN
beber	VB
bebida	NN
beicon	NN
beige	JJ
beis	JJ
béisbol	NN
beisbolista	NN
bella	JJ
bello	JJ
bendecir	VB
beneficiar	VB
beneficio	NN
benévola	JJ
benévolo	JJ
benigna	JJ
benigno	JJ
berenjena	NN
berilio	NN
besarse	VB
bestia	NN
biatlón	NN
Biblia	NNP
bibliografía	NN
biblioteca	NN
bibliotecaria	NN
bibliotecario	NN
bicentenario	NN
bicho	NN
bicicleta	NN
bien	RB
bienes	NN
bienestar	NN
bigote	NN
bigotes	NNS
bilingüe	JJ
billetera	NN
billón	JJ
bingo	NN
biodiversidad	NN
biología	NN
biológica	JJ
biológico	JJ
bis	NN
bisabuela	NN
bisabuelo	NN
bisagra	NN
bismuto	NN
bisnieta	NN
bisnieto	NN
bisonte	NN
bistec	NN
bizcocho	NN
blanca	JJ
blanco	JJ
blanda	JJ
blando	JJ
blanqueador	NN
blanquear	VB
blindaje	NN
bloc	NN
bloque	NN
blues	NN
blusa	NN
bobsleigh	NN
boca	NN
bocadillo	NN
bocina	NN
bocinazo	NN
boda	NN
bodega	NN
bola	NN
boletería	NN
boleto	NN
bolígrafo	NN
bolillo	NN
Bolivia	NNP
boliviana	JJ
boliviano	JJ
bolos	NNS
bolsa	NN
bolsillo	NN
bolso	NN
bomba	NN
bombera	NN
bombero	NN
bombillo	NN
bonachón	NN
bondad	NN
boñiga	NN
bonita	JJ
bonito	JJ
borde	NN
borla	NN
boro	NN
borrador	NN
borrar	VB
borrosa	JJ
borroso	JJ
bosque	NN
bosta	NN
bostezar	VB
bota	NN
botánica	NN
bote	NN
botella	NN
botín	NN
botiquín	NN
botón	NN
bóveda	NN
boxeo	NN
bozal	NN
branquia	NN
Brasil	NNP
brazo	NN
brecha	NN
brécol	NN
Bretaña	NNP
brillante	JJ
brillar	VB
brillo	NN
brincar	VB
brinco	NN
brío	NN
británica	JJ
británico	JJ
broche	NN
bróculi	NN
broma	NN
bromista	NN
bromo	NN
bronca	JJ
bronce	NN
bronceador	NN
bronco	JJ
brotar	VB
brote	NN
bruja	NN
brujería	NN
brujo	NN
brújula	NN
brutal	JJ
bucear	VB
buen	JJ
buena	JJ
bueno	JJ
buey	NN
búfalo	NN
bufanda	NN
búho	NN
buitre	NN
bujía	NN
buldog	NN
burbuja	NN
burbujear	VB
burda	JJ
burdo	JJ
burla	NN
burlarse	VB
burlas	NNS
burrito	NN
burro	NN
busardo	NN
buscar	VB
butaca	NN
butano	NN
buzo	NN
buzón	NN
cabalgar	VB
caballeriza	NN
caballero	NN
caballete	NN
caballo	NN
cabaña	NN
cabello	NN
caber	VB
cabeza	NN
cabezada	NN
cabina	NN
cable	NN
cabo	NN
cabra	NN
cabriolar	VB
caca	NN
cacahuete	NN
cacao	NN
cacerola	NN
cachucha	NN
cacique	NN
cacto	NN
cada	JJ
cadena	NN
cadera	NN
cadmio	NN
caducar	VB
caerse	VB
café	NN
cafeína	NN
cafetería	NN
caimán	NN
caja	NN
calcio	NN
calcular	VB
calendario	NN
cálida	JJ
cálido	JJ
calificar	VB
callada	JJ
callado	JJ
calurosa	JJ
caluroso	JJ
calzoncillos	NNS
calzones	NNS
cama	NN
cámara	NN
camarera	NN
camarero	NN
camarilla	NN
camarón	NN
camarones	NNS
cambiar	VB
cambio	NN
camello	NN
camilla	NN
caminar	VB
caminata	NN
camino	NN
camión	NN
camioneta	NN
camisa	NN
camiseta	NN
camisón	NN
campamento	NN
campana	NN
campaña	NN
campanario	NN
campanilla	NN
campeón	NN
campeona	NN
campeonato	NN
campesina	NN
campesino	NN
campo	NN
campocorto	NN
camuflaje	NN
camuflajear	VB
camuflar	VB
caña	NN
Canadá	NNP
canadiense	JJ
canal	NN
canario	NN
canasta	NN
cancelar	VB
cáncer	NN
cancha	NN
canción	NN
candidata	NN
candidato	NN
canela	NN
cangrejo	NN
canguro	NN
caníbal	NN
canilla	NN
canina	JJ
canino	JJ
canoa	NN
cañón	NN
cansada	JJ
cansado	JJ
cansar	VB
cantante	NN
cantar	VB
cantarín	NN
cantarina	NN
cántaro	NN
cantidad	NN
cantor	NN
cantora	NN
caoba	NN
caos	NN
capacidad	NN
caparazón	NN
capaz	JJ
capilar	NN
capilla	NN
capirote	NN
capital	NN
capitán	NN
capitana	NN
capítulo	NN
capó	NN
capricornio	NN
capucha	NN
caqui	JJ
cara	NN
caracol	NN
característica	NN
carámbano	NN
caramelo	NN
carbohidrato	NN
carbono	NN
carburador	NN
carcayú	NN
cárcel	NN
carcelera	NN
carcelero	NN
cardenal	NN
cárdigan	NN
cardióloga	NN
cardiólogo	NN
carga	NN
cargar	VB
caribú	NN
caricatura	NN
caricaturizar	VB
caricia	NN
caridad	NN
caries	NN
cariño	NN
cariñosa	JJ
cariñoso	JJ
caritativa	JJ
caritativo	JJ
carmesí	JJ
carnada	NN
carne	NN
carnicería	NN
caro	JJ
carpeta	NN
carpintera	NN
carpintero	NN
carrera	NN
carreta	NN
carretera	NN
carretilla	NN
carro	NN
carroza	NN
carrusel	NN
carta	NN
cartel	NN
cartera	NN
cartero	NN
cartílago	NN
cartón	NN
cartucho	NN
casa	NN
casarse	VB
cascabel	NN
cascar	VB
cáscara	NN
cascarrabias	JJ
casco	NN
casete	NN
casi	RB
casino	NN
castaña	JJ
castaño	JJ
castigar	VB
castigo	NN
castillo	NN
castor	NN
casual	JJ
casuario	NN
catálogo	NN
catarata	NN
catarina	NN
catarro	NN
catear	VB
catedral	NN
catedrática	NN
catedrático	NN
categoría	NN
católica	JJ
Catolicismo	NN
católico	JJ
catorce	JJ
caucho	NN
causa	NN
causar	VB
cautivante	JJ
cavar	VB
cavidad	NN
caza	NN
cazador	NN
cazadora	NN
cazar	VB
cazuela	NN
cebo	NN
cebolla	NN
cebra	NN
cecina	NN
ceder	VB
cedro	NN
ceja	NN
celador	NN
celadora	NN
celda	NN
celebración	NN
celebrar	VB
célebre	NN
celebridad	NN
celeste	JJ
celo	NN
celos	NNS
celosa	JJ
celoso	JJ
cementerio	NN
cemento	NN
cena	NN
cenar	VB
cencerro	NN
cenicienta	JJ
ceniciento	JJ
ceño	NN
censura	NN
centenario	NN
centígrada	JJ
centígrado	JJ
centímetro	NN
centro	NN
Centroamérica	NNP
centroamericana	JJ
centroamericano	JJ
centrocampista	NN
cepillo	NN
cera	NN
ceramista	NN
cerca	IN
cercanía	NN
cercanías	NNS
cerdo	NN
cereal	NN
cerebro	NN
ceremonia	NN
cereza	NN
cerezo	NN
cerio	NN
cero	JJ
cerradura	NN
cerrar	VB
cerro	NN
certera	JJ
certero	JJ
cervecería	NN
cerveza	NN
cesar	VB
cesio	NN
césped	NN
cesta	NN
cestería	NN
chaleco	NN
champán	NN
champaña	NN
champiñon	NN
champú	NN
chancho	NN
chancla	NN
chandal	NN
chapa	NN
chaqueta	NN
chaquetón	NN
charca	NN
charlar	VB
charqui	NN
chasquear	VB
chayote	NN
cheque	NN
chequera	NN
chequere	NN
chicle	NN
chiflar	VB
chiflido	NN
chile	NN
chilena	JJ
chileno	JJ
chillar	VB
chillido	NN
chillón	JJ
chillona	JJ
chimenea	NN
chimpancé	NN
China	NNP
china	JJ
China	NNP
chinche	NN
chincheta	NN
chinela	NN
chino	JJ
chip	NN
chisme	NN
chismorrear	VB
chismorreo	NN
chismosa	NN
chismoso	NN
chispa	NN
chiste	NN
chocar	VB
chocolate	NN
choque	NN
chorizo	NN
chovinismo	NN
chovinista	NN
choza	NN
chupar	VB
chupete	NN
chupón	NN
churro	NN
cicatriz	NN
ciclismo	NN
ciclista	NN
ciclo	NN
cíclope	NN
ciega	JJ
ciego	JJ
cielo	NN
ciempiés	NN
cien	JJ
ciénaga	NN
ciencias	NNS
científica	NN
científico	NN
cierta	JJ
ciertamente	RB
cierto	JJ
cifra	NN
cifrar	VB
cigüeña	NN
cilantro	NN
cilindro	NN
címbalo	NN
cinc	NN
cincel	NN
cinco	JJ
cincuenta	JJ
cine	NN
cineasta	NN
cinta	NN
cinto	NN
cintura	NN
cinturón	NN
circo	NN
círculo	NN
ciruela	NN
cirugía	NN
cirujana	NN
cirujano	NN
cisne	NN
cita	NN
citación	NN
citar	VB
ciudad	NN
ciudadana	NN
ciudadanía	NN
ciudadano	NN
civil	JJ
civilización	NN
clan	NN
clara	JJ
claramente	RB
clarinete	NN
clarinetista	NN
claro	JJ
clase	NN
clásica	JJ
clásico	JJ
clasificar	VB
claustro	NN
clave	JJ
clavel	NN
claves	NNS
clavícula	NN
clavo	NN
claxon	NN
clienta	NN
cliente	NN
clínica	NN
cloaca	NN
cloro	NN
club	NN
coagularse	VB
cobalto	NN
cobaya	NN
cobre	NN
cocaína	NN
coche	NN
cocina	NN
cocinar	VB
cocinera	NN
cocinero	NN
coco	NN
cocodrilo	NN
cocotero	NN
codera	NN
codiciosa	JJ
codicioso	JJ
código	NN
codo	NN
codorniz	NN
coeficiente	NN
coger	VB
cohete	NN
coja	JJ
cojear	VB
cojer	VB
cojera	NN
cojín	NN
cojinete	NN
cojo	JJ
col	NN
cola	NN
colaborar	VB
colchón	NN
colección	NN
coleccionar	VB
coleccionista	NN
colega	NN
colegio	NN
colegir	VB
colérica	JJ
colérico	JJ
colgar	VB
colibrí	NN
coliflor	NN
colina	NN
colisionar	VB
collar	NN
collarín	NN
colmada	JJ
colmado	JJ
colmar	VB
colmillo	NN
Colombia	NNP
colombiana	JJ
colombiano	JJ
colon	NN
colona	NN
colonia	NN
colono	NN
color	NN
colorido	NN
columna	NN
columpio	NN
coma	NN
comadreja	NN
combinación	NN
combinar	VB
combustible	NN
comedia	NN
comedor	NN
comején	NN
comentar	VB
comentario	NN
comenzar	VB
comer	VB
comerciante	NN
comerciar	VB
comercio	NN
comestibles	NNS
cometa	NN
cometer	VB
cómica	JJ
cómico	JJ
comida	NN
comienzo	NN
comillas	NNS
cómo	WRB
cómoda	JJ
comodín	NN
cómodo	JJ
compañera	NN
compañero	NN
compañía	NN
comparar	VB
compartir	VB
compás	NN
compasión	NN
compasiva	JJ
compasivo	JJ
competencia	NN
competir	VB
complacer	VB
compleja	JJ
complejidad	NN
complejo	JJ
completamente	RB
completar	VB
complicada	JJ
complicado	JJ
componer	VB
comportamiento	NN
composición	NN
compositor	NN
compositora	NN
comprar	VB
comprender	VB
comprensiva	JJ
comprensivo	JJ
compresa	NN
comprimir	VB
comprobar	VB
comprometer	VB
comprometerse	VB
compuerta	NN
compuesta	JJ
compuesto	JJ
computadora	NN
común	JJ
comunicar	VB
comunidad	NN
comunión	NN
comunismo	NN
comunista	JJ
con	IN
conceder	VB
concentrar	VB
concepto	NN
concha	NN
conciencia	NN
concierto	NN
concluir	VB
conclusión	NN
concreta	JJ
concreto	JJ
concusión	NN
condado	NN
conde	NN
condenar	VB
condensar	VB
condesa	NN
condimentos	NNS
cóndor	NN
conducir	VB
conducta	NN
conductor	JJ
conductora	JJ
conectar	VB
conejito	NN
conejo	NN
conexión	NN
confesar	VB
confiable	JJ
confiada	JJ
confiado	JJ
confianza	NN
confiar	VB
conflicto	NN
confundir	VB
confundirse	VB
conga	NN
congelación	NN
congelada	JJ
congelado	JJ
congelar	VB
congresista	NN
Congreso	NNP
conmigo	RB
conmovedor	JJ
conmovedora	JJ
conmover	VB
cono	NN
conocer	VB
conquistador	NN
conquistar	VB
conseguir	VB
consejera	NN
consejero	NN
consejo	NN
consejos	NNS
consentida	JJ
consentido	JJ
conservar	VB
considerablemente	RB
consideración	NN
considerado	JJ
considerar	VB
consigna	NN
consigo	RB
consolador	NN
consoladora	NN
constante	JJ
constantemente	RB
constelación	NN
consternación	NN
constitución	NN
constitucional	JJ
constituir	VB
construcción	NN
construir	VB
consultiva	JJ
consultivo	JJ
consumir	VB
contacto	NN
contador	NN
contadora	NN
contaminación	NN
contaminar	VB
contar	VB
contemporánea	JJ
contemporáneo	JJ
contenedor	NN
contener	VB
contenta	JJ
contentar	VB
contento	JJ
contestar	VB
contigo	RB
continental	JJ
continente	NN
continuar	VB
contra	IN
contrabajo	NN
contrabando	NN
contradecir	VB
contraponer	VB
contraseña	NN
contratar	VB
contratista	NN
contraventana	NN
contribución	NN
contribuir	VB
contribuyente	NN
control	NN
controlar	VB
controvertida	JJ
controvertido	JJ
controvertir	VB
convencer	VB
convención	NN
conveniente	JJ
convenir	VB
conversa	NN
conversación	NN
conversar	VB
converso	NN
convertible	JJ
convertir	VB
convertirse	VB
convincente	JJ
convivir	VB
convocar	VB
cooperación	NN
coordinador	NN
coordinadora	NN
copia	NN
copiar	VB
coraje	NN
coral	NN
Corán	NNP
corazón	NN
corbata	NN
corchetes	NNS
cordel	NN
cordero	NN
cordillera	NN
cordón	NN
Corea	NNP
coreografía	NN
corneta	NN
coro	NN
corona	NN
corporal	JJ
corporativa	JJ
corporativo	JJ
corral	NN
correa	NN
corrección	NN
correcta	JJ
correcto	JJ
corredor	NN
corredora	NN
corregir	VB
correo	NN
correr	VB
correspondencia	NN
corresponderse	VB
corresponsal	NN
corriente	JJ
corromper	VB
corrupción	NN
corrupta	JJ
corrupto	JJ
corta	JJ
cortar	VB
cortarse	VB
corte	NN
cortés	JJ
corteza	NN
cortina	NN
corto	JJ
cosa	NN
cosecha	NN
coser	VB
cosido	NN
cosmos	NN
cosquilleo	NN
cosquillosa	JJ
cosquilloso	JJ
costa	NN
costado	NN
costar	VB
costarricense	JJ
costilla	NN
costosa	JJ
costoso	JJ
costumbre	NN
costumbrista	JJ
costura	NN
costurar	VB
cotidiana	JJ
cotidiano	JJ
coyote	NN
crack	NN
cráneo	NN
crayola	NN
crayón	NN
creación	NN
creador	NN
creadora	NN
crear	VB
creativa	JJ
creativo	JJ
crecer	VB
crecimiento	NN
crédito	NN
creencia	NN
creer	VB
cremallera	NN
crepuscular	JJ
crepúsculo	NN
creyente	NN
criar	VB
criarse	VB
criatura	NN
crimen	NN
criminal	NN
criolla	JJ
criollo	JJ
crisantemo	NN
cristiana	JJ
cristianismo	NN
cristiano	JJ
crítica	JJ
criticar	VB
crítico	JJ
cromo	NN
cruce	NN
crucero	NN
crucificar	VB
crucifixión	NN
cruda	JJ
crudo	JJ
crujiente	JJ
crujir	VB
crustáceo	NN
cruz	NN
cruzar	VB
cuaderno	NN
cuadra	NN
cuadrangular	NN
cuadro	NN
cuádruple	JJ
cuadruplicar	VB
cuadruplicarse	VB
Cual	RB
cuál	WP
cualidad	NN
cualitativa	JJ
cualitativo	JJ
cualquier	RB
cuándo	WRB
Cuántas	RB
Cuántos	RB
cuarenta	JJ
cuarta	JJ
cuarto	JJ
cuata	NN
cuate	NN
cuatro	JJ
cuatrocientas	JJ
cuatrocientos	JJ
Cuba	NNP
cubana	JJ
cubano	JJ
cubierta	NN
cubismo	NN
cubito	NN
cubo	NN
cubrir	VB
cucaracha	NN
cuchara	NN
cuchillo	NN
cueca	NN
cuello	NN
cuenco	NN
cuenta	NN
cuentista	NN
cuento	NN
cuerda	NN
cuero	NN
cuerpo	NN
cuervo	NN
cueva	NN
cuidadosa	JJ
cuidadosamente	RB
cuidadoso	JJ
cuidar	VB
culebra	NN
culminar	VB
culpable	JJ
culpar	VB
cultivar	VB
cultivo	NN
culto	NN
cultura	NN
cultural	JJ
cumbia	NN
cumpleaños	NN
cuna	NN
cuñada	NN
cuñado	NN
cuota	NN
cúpola	NN
cupón	NN
cura	NN
curandera	NN
curandero	NN
curar	VB
curiosa	JJ
curioso	JJ
curita	NN
curling	NN
cursivo	NN
cursor	NN
curva	NN
dada	JJ
dado	JJ
daga	NN
dama	NN
damas	NN
dañar	VB
dañina	JJ
dañino	JJ
danzanta	NN
danzante	NN
danzón	NN
dar	VB
dardo	NN
Daredevil	NNP
datos	NN
de	IN
de vainilla	NN
debajo	IN
deber	VB
débil	JJ
debilucha	NN
debilucho	NN
década	NN
decadencia	NN
decatlón	NN
decente	JJ
decidir	VB
décima	JJ
decimal	JJ
décimo	JJ
decimocuarta	JJ
decimocuarto	JJ
decimotercera	JJ
decimotercero	JJ
decir	VB
decisiva	JJ
decisivo	JJ
decoración	NN
decorar	VB
decorativa	JJ
decorativo	JJ
dedal	NN
dedicarse	VB
dedo	NN
deducir	VB
defender	VB
defenderse	VB
defensa	NN
defensor	NN
defensora	NN
definición	NN
definir	VB
definitivamente	RB
degradar	VB
dejar	VB
del	IN
delantal	NN
delantera	NN
delantero	NN
deletrear	VB
delfín	NN
delgada	JJ
delgado	JJ
delicada	JJ
delicado	JJ
delincuente	NN
delinquir	VB
demandar	VB
demás	NN
demasiada	RB
demasiado	RB
democracia	NN
demócrata	NN
democrática	JJ
democrático	JJ
demolir	VB
demonio	NN
dentista	NN
dentro	RB
departamento	NN
depender	VB
deportación	NN
deporte	NN
deportista	NN
deportividad	NN
depositar	VB
depósito	NN
depredador	NN
depredadora	NN
deprimente	JJ
deprimir	VB
deprimirse	VB
derecha	JJ
derechista	JJ
derecho	JJ
dermatóloga	NN
dermatólogo	NN
derramar	VB
derrame	NN
derretir	VB
derrocar	VB
derrota	NN
derrotar	VB
derrumbe	NN
desabrocharse	VB
desactivar	VB
desafiar	VB
desafío	NN
desafortunada	JJ
desafortunadamente	RB
desafortunado	JJ
desaguar	VB
desagüe	NN
desahogar	VB
desahogo	NN
desamarrar	VB
desanimar	VB
desaparecer	VB
desarmar	VB
desarreglada	JJ
desarreglado	JJ
desarrollar	VB
desastre	NN
desayunar	VB
desayuno	NN
descansar	VB
descanso	NN
descapotable	NN
descarga	NN
descargar	VB
descendencia	NN
descender	VB
descendiente	NN
descenso	NN
descifrar	VB
descolgar	VB
desconfiada	JJ
desconfiado	JJ
descongelar	VB
descongestionante	NN
desconsiderada	JJ
desconsiderado	JJ
descorazonada	JJ
descorazonado	JJ
descorazonar	VB
descripción	NN
descubierta	JJ
descubierto	JJ
descubrimiento	NN
descubrir	VB
descuento	NN
descuidada	JJ
descuidado	JJ
desdoblar	VB
desear	VB
desempleo	NN
desenvolver	VB
deseo	NN
desfiladero	NN
desfilar	VB
desfile	NN
deshacer	VB
deshidratación	NN
deshidratar	VB
deshonrosa	JJ
deshonroso	JJ
desierto	NN
designar	VB
desigual	JJ
desilusionar	VB
deslizarse	VB
deslumbar	VB
desnuda	JJ
desnudo	JJ
desobedecer	VB
desobediente	JJ
desodorante	NN
desolador	JJ
desoladora	JJ
desordenada	JJ
desordenado	JJ
despedirse	VB
despegar	VB
despejar	VB
desperdicio	NN
despertador	NN
despertarse	VB
despido	NN
después	RB
destacada	JJ
destacado	JJ
destacar	VB
destapar	VB
deste	JJ
desteñir	VB
destinataria	NN
destinatario	NN
destornillador	NN
destreza	NN
destrozar	VB
destructiva	JJ
destructivo	JJ
destructor	NN
destruir	VB
desvelación	NN
desvelar	VB
desventaja	NN
detalle	NN
detective	NN
detención	NN
detener	VB
determinar	VB
determinismo	NN
detestar	VB
detonar	VB
deuda	NN
devoción	NN
devolver	VB
devorar	VB
devota	JJ
devoto	JJ
día	NN
diabetes	NN
diablo	NN
diácona	NN
diácono	NN
diagrama	NN
diamante	NN
diámetro	NN
diapositiva	NN
diaria	JJ
diariamente	RB
diario	JJ
diarrea	NN
dibujante	NN
dibujar	VB
dibujo	NN
diccionario	NN
dicho	NN
diciembre	NN
dictador	NN
dictadora	NN
dictadura	NN
diecinueve	JJ
dieciocho	JJ
dieciséis	JJ
diecisiete	JJ
diente	NN
dientes	NNS
diestra	JJ
diestro	JJ
dieta	NN
diez	JJ
diezmo	NN
diferencia	NN
diferenciar	VB
diferente	JJ
diferir	VB
difícil	JJ
dificilísima	JJ
dificilísimo	JJ
dificultad	NN
dificultar	VB
digital	JJ
dimensión	NN
dinosaurio	NN
dios	NN
diplomática	NN
diplomático	NN
diputada	NN
diputado	NN
dirección	NN
direccional	NN
directa	JJ
directo	JJ
director	NN
directora	NN
dirigir	VB
discípula	NN
discípulo	NN
disco	NN
discrepar	VB
disculpar	VB
discurso	NN
discusión	NN
discutir	VB
diseñar	VB
diseño	NN
disfraz	NN
disfrazar	VB
disfrutar	VB
disinfectante	NN
disinfectar	VB
dislocar	VB
disminuir	VB
disparador	NN
disparar	VB
disparo	NN
disponible	JJ
disprosio	NN
distancia	NN
distracción	NN
distribuir	VB
distrito	NN
diversa	JJ
diversidad	NN
diversificar	VB
diversión	NN
diverso	JJ
divertida	JJ
divertido	JJ
divertirse	VB
dividir	VB
división	NN
divorciarse	VB
divorcio	NN
dnorte	JJ
doblar	VB
doble	JJ
doce	JJ
doceava	JJ
doceavo	JJ
docena	NN
doctrina	NN
documental	NN
documentar	VB
documento	NN
doeste	JJ
dólar	NN
doler	VB
dolor	NN
domador	NN
domadora	NN
domestica	JJ
domestico	JJ
dominante	JJ
dominar	VB
domingo	NN
dominicana	JJ
dominicano	JJ
dominio	NN
dominó	NN
donación	NN
donar	VB
dónde	WRB
dormilón	NN
dormir	VB
dormitorio	NN
dorsal	JJ
dos	JJ
doscientas	JJ
doscientos	JJ
dragón	NN
drama	NN
dramaticamente	RB
dramaturga	NN
dramaturgo	NN
driblar	VB
droga	NN
ducharse	VB
duda	NN
dudar	VB
dudosa	JJ
dudoso	JJ
duelo	NN
dulce	NN
dulces	NNS
dúo	NN
duodécima	JJ
duodécimo	JJ
duplicar	VB
duplicarse	VB
duque	NN
duquesa	NN
dura	JJ
duradera	JJ
duradero	JJ
durante	IN
durar	VB
durazno	NN
duro	JJ
DVD	NN
echar	VB
eclipsar	VB
eclipse	NN
eco	NN
ecológica	JJ
ecológico	JJ
economía	NN
económica	JJ
económico	JJ
ecosistema	NN
ecuación	NN
Ecuador	NNP
ecuatoriana	JJ
ecuatoriano	JJ
edición	NN
edificio	NN
edredón	NN
educación	NN
educada	JJ
educado	JJ
educativa	JJ
educativo	JJ
efecto	NN
eficaz	JJ
eficazmente	RB
eficiencia	NN
eficiente	JJ
eje	NN
ejecución	NN
ejecutiva	NN
ejecutivo	NN
ejemplar	NN
ejemplo	NN
ejercer	VB
ejercicio	NN
ejército	NN
el	DT
él	PRP
elástica	JJ
elástico	JJ
elección	NN
electoral	JJ
eléctrica	JJ
electricidad	NN
electricista	NN
eléctrico	JJ
electrolito	NN
electrón	NN
elefante	NN
elegante	JJ
elegir	VB
elemento	NN
elevada	JJ
elevado	JJ
elevar	VB
elfo	NN
eliminar	VB
elipse	NN
elipsis	NN
ella	PRP
ellas	PRP
ellos	PRP
elote	NN
embajada	NN
embajador	NN
embajadora	NN
embarazada	JJ
embarazosa	JJ
embarazoso	JJ
embarcar	VB
embellecer	VB
émbolo	NN
embrague	NN
embrujo	NN
emergencia	NN
emitir	VB
emoción	NN
emocionada	JJ
emocionado	JJ
emocionante	JJ
emocionar	VB
emocionarse	VB
empanada	NN
empapelar	VB
empatar	VB
empate	NN
empeñar	VB
empeñarse	VB
empeño	NN
emperador	NN
emperadora	NN
empezar	VB
empleada	NN
empleado	NN
emplear	VB
empresa	NN
empujar	VB
en	IN
en adobo	JJ
en blanco	JJ
enagua	NN
enamorarse	VB
enana	NN
enano	NN
encadenar	VB
encaje	NN
encantada	JJ
encantado	JJ
encantar	VB
encanto	NN
encarcelar	VB
encargarse	VB
encarte	NN
encendedor	NN
encender	VB
encerrar	VB
encestar	VB
enchilada	NN
enchufe	NN
enciclopedia	NN
encima	IN
enclavar	VB
encogida	JJ
encogido	JJ
encontrar	VB
encontrarse	VB
encuentro	NN
encuesta	NN
encurtir	VB
eneldo	NN
enemigo	NN
energía	NN
enero	NN
enfadar	VB
enferma	JJ
enfermar	VB
enfermarse	VB
enfermedad	NN
enfermera	NN
enfermería	NN
enfermero	NN
enfermo	JJ
enfocar	VB
enfrentamiento	NN
enfrentar	VB
enfurecer	VB
engañar	VB
enganchar	VB
engranaje	NN
engrandecer	VB
engrapar	VB
enigma	NN
enjaular	VB
enjuagar	VB
enlace	NN
enlazar	VB
enloquecer	VB
enmendar	VB
enmienda	NN
enojada	JJ
enojado	JJ
enojarse	VB
enorme	JJ
ensalada	NN
ensayista	NN
ensayo	NN
enseñar	VB
ensillar	VB
entablillar	VB
entender	VB
entera	JJ
enterar	VB
enterarse	VB
entero	JJ
enterrar	VB
entonces	RB
entrada	NN
entrar en	VB
entre	IN
entrecruzar	VB
entregar	VB
entrenador	NN
entrenadora	NN
entrenamiento	NN
entrenar	VB
entretanto	RB
entretener	VB
entretenida	JJ
entretenido	JJ
entrevenir	VB
entrevista	NN
entrevistar	VB
entristecer	VB
entristecerse	VB
entumecer	VB
entumecida	JJ
entumecido	JJ
entusiasmada	JJ
entusiasmado	JJ
entusiasmar	VB
entusiasmo	NN
enumerar	VB
envasar	VB
envase	NN
enviar	VB
envidia	NN
envidiar	VB
envidiosa	JJ
envidioso	JJ
envío	NN
envolver	VB
epazote	NN
epifanía	NN
episodio	NN
época	NN
equilibrada	JJ
equilibrado	JJ
equilibrar	VB
equilibrio	NN
equipaje	NN
equipo	NN
equitación	NN
equívoca	JJ
equivocada	JJ
equivocado	JJ
equivocarse	VB
equívoco	JJ
erbio	NN
ergonómica	JJ
ergonómico	JJ
erigir	VB
erosión	NN
error	NN
erudita	NN
erudito	NN
erupción	NN
esa	JJ
escala	NN
escalar	VB
escalera	NN
escaleras	NNS
escalfar	VB
escalofrío	NN
escalofríos	NNS
escalón	NN
escalope	NN
escandio	NN
escáner	NN
escaparse	VB
escape	NN
escarabajo	NN
escarlata	JJ
escarpada	JJ
escarpado	JJ
escasez	NN
escena	NN
escenario	NN
esclava	NN
esclavizar	VB
esclavo	NN
esclusa	NN
escoba	NN
escocés	JJ
escocesa	JJ
escoger	VB
escolar	JJ
escoliosis	NN
esconder	VB
esconderse	VB
escondite	NN
escorpión	NN
escribana	NN
escribano	NN
escribir	VB
escribirse	VB
escrito	NN
escritor	NN
escritora	NN
escritorio	NN
escritura	NN
escrutinio	NN
escuchar	VB
escudero	NN
escudo	NN
escudriñar	VB
escuela	NN
escueprimaria	NN
escuesecundaria	NN
escultor	NN
escultora	NN
escultura	NN
ese	JJ
esencial	JJ
esencialmente	RB
esfera	NN
esfínter	NN
esforzarse	VB
esgrima	NN
eslabón	NN
eslalom	NN
esmaltar	VB
esmalte	NN
esmeralda	NN
esmoquin	NN
esotérica	JJ
esotérico	JJ
espacio	NN
espaciosa	JJ
espacioso	JJ
espada	NN
espagueti	NN
espaguetis	NN
espalda	NN
España	NNP
español	JJ
española	JJ
espantosa	JJ
espantoso	JJ
esparcir	VB
espárrago	NN
espátula	NN
especial	JJ
especialista	NN
especialmente	RB
especie	NN
específicamente	RB
espécimen	NN
espectador	NN
espectadora	NN
espectro	NN
especular	VB
espejo	NN
esperanza	NN
esperanzadamente	RB
esperanzado	JJ
esperar	VB
espía	NN
espiar	VB
espina	NN
espinaca	NN
espinacas	NN
espinilla	NN
espiral	NN
espíritu	NN
espiritual	JJ
esplendor	NN
espliego	NN
esponja	NN
esponjosa	JJ
esponjoso	JJ
espontánea	JJ
espontáneo	JJ
esposa	NN
esposar	VB
esposas	NNS
esposo	NN
esprintar	VB
espuela	NN
espuma	NN
esqueleto	NN
esquema	NN
esquí	NN
esquiar	VB
esquina	NN
estable	JJ
establecer	VB
establecerse	VB
establecimiento	NN
establo	NN
estación	NN
estacionamiento	NN
estacionar	VB
estadio	NN
estado	NN
estadounidense	JJ
estafa	NN
estafar	VB
estallar	VB
estaño	NN
estanque	NN
estante	NN
estantería	NN
estar	VB
estas	JJ
estatal	JJ
estática	JJ
estático	JJ
estatua	NN
este	NN
estelar	JJ
estereotipo	NN
esterilizar	VB
esternón	NN
estética	JJ
estético	JJ
estiércol	NN
estilo	NN
estima	NN
estimar	VB
estimular	VB
estómago	NN
estorbar	VB
estorbo	NN
estornudar	VB
estornudo	NN
estos	JJ
estrafalaria	JJ
estrafalario	JJ
estrategia	NN
estrecha	JJ
estrecho	JJ
estrella	NN
estrés	NN
estribo	NN
estridente	JJ
estrike	NN
estroncio	NN
estructura	NN
estuco	NN
estudiantado	NN
estudiante	NN
estudiar	VB
estudio	NN
estufa	NN
estupenda	JJ
estupendo	JJ
estupidez	NN
estupor	NN
etapa	NN
ética	NN
etiqueta	NN
étnica	JJ
étnico	JJ
europea	JJ
Europeo	NNP
europeo	JJ
Europeo	NNP
europio	NN
evaluar	VB
evangélica	JJ
evangélico	JJ
evangelio	NN
evangelista	NN
evento	NN
evidencia	NN
evitar	VB
evolucionar	VB
exagerada	JJ
exagerado	JJ
examen	NN
excavar	VB
excedente	NN
excelente	JJ
excepción	NN
excepcional	JJ
exceso	NN
excluidos	JJ
excluir	VB
exclusiva	JJ
exclusivo	JJ
excursión	NN
exhortar	VB
exhosto	NN
exigencia	NN
exigir	VB
exilio	NN
existir	VB
exitosa	JJ
exitoso	JJ
expectante	JJ
expectativa	NN
expedir	VB
experiencia	NN
experimentación	NN
experimentar	VB
experimento	NN
expirar	VB
explicar	VB
explorador	NN
exploradora	NN
explorar	VB
explosión	NN
explosiva	JJ
explosivo	JJ
exportación	NN
exportar	VB
exposición	NN
expositor	NN
expositora	NN
expresar	VB
expulsar	VB
extender	VB
extensa	JJ
extensión	NN
extenso	JJ
exterior	JJ
exterminar	VB
extinción	NN
extinguir	VB
extraer	VB
extraña	JJ
extranjera	JJ
extranjero	JJ
extraño	JJ
extraordinaria	JJ
extraordinario	JJ
extraterrestre	NN
extravagante	JJ
extremo	NN
eyectarse	VB
fábrica	NN
fabricación	NN
fabricar	VB
fabulosa	JJ
fabuloso	JJ
facción	NN
fácil	JJ
fácilmente	JJ
factible	JJ
factor	NN
facturar	VB
fagot	NN
fahrenheit	JJ
faisán	NN
falda	NN
fallar	VB
fallo	NN
falsa	JJ
falso	JJ
falta	NN
faltar	VB
familia	NN
familiar	JJ
famosa	JJ
famoso	JJ
fantasía	NN
fantasma	NN
fantasmagórica	JJ
fantasmagórico	JJ
fantástica	JJ
fantástico	JJ
farmacia	NN
faro	NN
farola	NN
fascinante	JJ
fascinar	VB
fase	NN
faul	NN
fauna	NN
favor	NN
favorecer	VB
favorita	JJ
favorito	JJ
fax	NN
faz	NN
fe	NN
fea	JJ
febrero	NN
fecha	NN
fécula	NN
felicidad	NN
felicidades	NNS
felicitar	VB
femenina	JJ
femenino	JJ
fenómeno	NN
feo	JJ
feria	NN
fermentar	VB
ferretería	NN
ferrocarril	NN
fertilizante	NN
ferviente	JJ
fervientemente	RB
festiva	JJ
festivo	JJ
fetiche	NN
fibra	NN
ficción	NN
ficha	NN
ficticia	JJ
ficticio	JJ
fidedigno	JJ
fidelidad	NN
fideo	NN
fiebre	NN
fiel	JJ
fiera	JJ
fiero	JJ
fiesta	NN
figura	NN
figurita	NN
fija	JJ
fijador	NN
fijarse	VB
fijo	JJ
fila	NN
filmadora	NN
fin	NN
fina	JJ
final	NN
finalmente	RB
financiera	JJ
financiero	JJ
finca	NN
fingir	VB
fino	JJ
firma	NN
firmar	VB
firme	JJ
física	NN
flaca	JJ
flaco	JJ
flamenco	NN
flan	NN
flaquear	VB
flauta	NN
flautín	NN
flautista	NN
flecha	NN
flexible	JJ
floja	JJ
flojo	JJ
flor	NN
flora	NN
floreada	JJ
floreado	JJ
florecer	VB
florero	NN
florescente	JJ
floristería	NN
flota	NN
flotar	VB
fluir	VB
flujo	NN
fluor	NN
fluorescente	JJ
foca	NN
foco	NN
fogata	NN
fogosa	JJ
fogoso	JJ
follaje	NN
folleto	NN
fondo	NN
fondue	NN
forma	NN
formal	JJ
formar	VB
formatear	VB
formato	NN
formón	NN
fórmula	NN
formulario	NN
fornida	JJ
fornido	JJ
forraje	NN
forrajear	VB
fortalecerse	VB
fosforera	NN
fósforo	NN
fosíl	NN
foto	NN
fotografía	NN
fotografiar	VB
fracasar	VB
fracaso	NN
fracción	NN
fracturar	VB
frágil	JJ
fragmento	NN
fraile	NN
frambuesa	NN
francamente	RB
francés	JJ
francesa	JJ
Francia	NNP
francio	NN
francotirador	NN
francotiradora	NN
franja	NN
franquicia	NN
frase	NN
fraternidad	NN
frecuentemente	RB
fregadero	NN
fregar	VB
fregona	NN
freír	VB
frenar	VB
freno	NN
frente	NN
fresa	NN
fresca	JJ
fresco	JJ
fría	JJ
fricción	NN
frijol	NN
frijoles	NNS
frío	JJ
frisbee	NN
frita	JJ
frito	JJ
frontal	JJ
frontera	NN
frotar	VB
fruncir	VB
frustrante	JJ
frustrar	VB
fruta	NN
frutería	NN
fuego	NN
fuente	NN
fuera	RB
fuerte	JJ
fuerza	NN
fugarse	VB
fumar	VB
funámbula	NN
funámbulo	NN
funcionar	VB
fundamental	JJ
fundamentalista	JJ
fundamentalmente	RB
fundar	VB
fúnebre	JJ
funeral	NN
funk	NN
furiosa	JJ
furioso	JJ
fusil	NN
fusilar	VB
fusión	NN
fusta	NN
fútbol	NN
futuro	NN
gabinete	NN
gacela	NN
gadolinio	NN
gafas	NNS
gaita	NN
galáctica	JJ
galáctico	JJ
galán	NN
galardón	NN
galardonar	VB
galaxia	NN
galería	NN
galio	NN
galleta	NN
gallina	NN
gallo	NN
gana	NN
ganadería	NN
ganado	NN
ganador	NN
ganadora	NN
ganancia	NN
ganar	VB
ganarse	VB
gancho	NN
ganga	NN
gángster	NN
gansa	NN
ganso	NN
garabatos	NNS
garaje	NN
garantizar	VB
garganta	NN
garrapata	NN
garrapatear	VB
garrobo	NN
garrocha	NN
gaseosa	NN
gasolina	NN
gasolinera	NN
gastar	VB
gatillo	NN
gatita	NN
gatito	NN
gato	NN
gazpacho	NN
géiser	NN
gel	NN
gelatina	NN
gema	NN
gemelo	NN
gemido	NN
géminis	NN
gemir	VB
gene	NN
generación	NN
general	NN
generalísimo	NN
generalmente	JJ
género	NN
generosa	JJ
generoso	JJ
genética	JJ
genético	JJ
genia	NN
genio	NN
genocidio	NN
gente	NN
geografía	NN
geóloga	NN
geólogo	NN
geometría	NN
geométrica	JJ
geométrico	JJ
gerente	NN
germanio	NN
germen	NN
gestar	VB
gesticular	VB
gesto	NN
gestor	NN
gestora	NN
ghetto	NN
gigante	JJ
gigantesca	JJ
gigantesco	JJ
gimnasia	NN
gimnasio	NN
gimotear	VB
ginecóloga	NN
ginecólogo	NN
girar	VB
girasol	NN
glaciar	NN
globo	NN
globo ocular	NN
glotón	NN
glotona	NN
gobernador	NN
gobernadora	NN
gobernante	NN
gobernar	VB
gobierno	NN
golf	NN
golfo	NN
golondrina	NN
golpe	NN
golpear	VB
golpeteo	NN
goma	NN
googlear	VB
gorda	JJ
gordo	JJ
gorila	NN
gorra	NN
gorro	NN
gota	NN
gótica	JJ
gótico	JJ
gozar	VB
gozo	NN
gozosa	JJ
gozoso	JJ
grabado	NN
grabadora	NN
grabar	VB
gracia	NN
graciosa	JJ
gracioso	JJ
graduación	NN
graduarse	VB
graffiti	NN
gráfica	JJ
gráfico	JJ
grafito	NN
gramática	NN
gramatical	JJ
gramo	NN
granate	NN
grande	JJ
granero	NN
granito	NN
granizar	VB
granizo	NN
granja	NN
granjera	NN
granjero	NN
grano	NN
grapa	NN
grapadora	NN
grapar	VB
grasa	NN
grasosa	JJ
grasoso	JJ
gravedad	NN
gravemente	RB
graznar	VB
graznido	NN
grieta	NN
grillo	NN
gringa	NN
gringo	NN
gripe	NN
gris	JJ
gritar	VB
grito	NN
gruñido	NN
gruñir	VB
grupo	NN
guacamole	NN
guanábana	NN
guante	NN
guapa	JJ
guapo	JJ
guaracha	NN
guaraní	JJ
guardabarros	NN
guardabosque	NN
guardameta	NN
guardapelo	NN
guardar	VB
guardarropa	NN
guardería	NN
guardia	NN
guardián	NN
guardiana	NN
Guatemala	NNP
guatemalteca	JJ
guatemalteco	JJ
guayaba	NN
guerra	NN
guerrera	NN
guerrero	NN
guía	NN
guiar	VB
guijarro	NN
guión	NN
guionista	NN
guirnalda	NN
güiro	NN
guisante	NN
guitarra	NN
guitarrista	NN
gusano	NN
gustar	VB
ha	VB
habanera	NN
habilidad	NN
habitación	NN
habitante	NN
habitual	JJ
hablante	NN
hablar	VB
hablarse	VB
hacer	VB
hacerse	VB
hacha	NN
hacienda	NN
hafnio	NN
halcón	NN
hallar	VB
halterofilia	NN
hambre	NN
hambruna	NN
hamburguesa	NN
hardware	NN
harina	NN
harta	JJ
harto	JJ
hasta	IN
hazaña	NN
hebilla	NN
hecha	JJ
hechicería	NN
hechizar	VB
hechizo	NN
hecho	JJ
heder	VB
heladería	NN
helar	VB
helio	NN
hemisferio	NN
heptatlón	NN
heredar	VB
heredera	NN
heredero	NN
hereje	NN
herética	JJ
herético	JJ
herida	NN
herir	VB
hermana	NN
hermanastra	NN
hermanastro	NN
hermandad	NN
hermano	NN
hermanos	NNS
héroe	NN
heroica	JJ
heroico	JJ
heroína	NN
herradura	NN
herramienta	NN
herrar	VB
hervir	VB
hexágono	NN
hidrante	NN
hidratación	NN
hidratar	VB
hidráulica	JJ
hidráulico	JJ
hidrógeno	NN
hierba	NN
hierro	NN
hígado	NN
higiene	NN
higiénica	JJ
higiénico	JJ
hija	NN
hijastra	NN
hijastro	NN
hijo	NN
hijos	NNS
hilar	VB
hilo	NN
hilo dental	NN
himnario	NN
himno	NN
hinchable	JJ
hinchada	JJ
hinchado	JJ
hincharse	VB
hipar	VB
hiperactiva	JJ
hiperactivo	JJ
hipérbola	NN
hipérbole	NN
hipnotizar	VB
hipo	NN
hipócrita	NN
hipopótamo	NN
hipotética	JJ
hipotético	JJ
hispana	JJ
hispánica	JJ
hispánico	JJ
hispano	JJ
hispanohablante	NN
histérica	JJ
histérico	JJ
historia	NN
historiador	NN
historiadora	NN
histórica	JJ
histórico	JJ
hocico	NN
hockey	NN
hogar	NN
hoja	NN
Holanda	NNP
holandés	JJ
holgazán	JJ
holgazana	JJ
holmio	NN
hombre	NN
hombrera	NN
hombro	NN
homenaje	NN
homenajear	VB
homosexual	JJ
Honduras	NNP
hondureña	JJ
hondureño	JJ
honesta	JJ
honesto	JJ
hongo	NN
hongos	NN
honor	NN
honorable	JJ
honorar	VB
honrada	JJ
honradez	NN
honrado	JJ
hora	NN
horario	NN
horizonte	NN
hormiga	NN
horno	NN
horóscopo	NN
horquilla	NN
horrible	JJ
horror	NN
hospital	NN
hospitalidad	NN
hotel	NN
hoy	RB
hoyo	NN
huella	NN
huérfana	NN
huérfano	NN
hueso	NN
huesuda	JJ
huesudo	JJ
huevo	NN
huir	VB
hule	NN
Hulk	NNP
humana	JJ
humanidad	NN
humano	JJ
húmeda	JJ
húmedo	JJ
humidificador	NN
humildad	NN
humilde	JJ
humillar	VB
humo	NN
hundir	VB
huracán	NN
hurón	NN
ícono	NN
ida	NN
idea	NN
idealista	JJ
identificación	NN
idioma	NN
idiomática	JJ
idiomático	JJ
idiota	NN
iglesia	NN
iglú	NN
ignorar	VB
igualmente	RB
iguana	NN
iluminar	VB
ilustrar	VB
imagen	NN
imaginación	NN
imaginativa	JJ
imaginativo	JJ
imán	NN
imbécil	NN
imitar	VB
impacientarse	VB
impaciente	JJ
impacto	NN
impar	JJ
imparcial	JJ
impedir	VB
impenetrable	JJ
imperdible	NN
imperio	NN
impermeable	NN
impersonal	JJ
impersonar	VB
impetuosa	JJ
impetuoso	JJ
implicar	VB
implicarse	VB
implorar	VB
imponente	JJ
imponer	VB
importación	NN
importante	JJ
importar	VB
imposible	JJ
impotente	JJ
impregnable	JJ
impresión	NN
impresionante	JJ
impresionismo	NN
impresionista	JJ
impresora	NN
imprevisible	JJ
imprimir	VB
improbable	JJ
impudencia	NN
impuestos	NNS
impulsar	VB
impulso	NN
inadecuada	JJ
inadecuado	JJ
inalámbrica	JJ
inalámbrico	JJ
inanimada	JJ
inanimado	JJ
inapropiada	JJ
inapropiado	JJ
incansable	JJ
incapacitada	JJ
incapacitado	JJ
incapacitar	VB
incapaz	JJ
incendio	NN
incesante	JJ
incitar	VB
inclinación	NN
inclinada	JJ
inclinado	JJ
inclinar	VB
inclinarse	VB
incluir	VB
incluso	RB
incómoda	JJ
incómodo	JJ
incomprensible	JJ
incomprensiva	JJ
incomprensivo	JJ
inconsciente	JJ
inconsistente	JJ
inconstante	JJ
inconstitucional	JJ
incorrecta	JJ
incorrecto	JJ
increíble	JJ
incrementar	VB
incremento	NN
incubadora	NN
incursionar	VB
independiente	NN
indescriptible	JJ
indeseable	JJ
India	NNP
indicar	VB
indicativa	JJ
indicativo	JJ
índice	NN
indígena	JJ
indigente	JJ
indignada	JJ
indignado	JJ
indio	NN
indirecta	NN
indizar	VB
indolora	JJ
indoloro	JJ
Indonesia	NNP
indudablemente	RB
indulgencia	NN
industria	NN
industrial	JJ
inexperta	JJ
inexperto	JJ
inexplicable	JJ
infanta	NN
infante	NN
infantería	NN
infantil	JJ
infarto	NN
infección	NN
infectar	VB
infierno	NN
infinitivo	NN
inflación	NN
inflamarse	VB
infligir	VB
influencia	NN
influir	VB
información	NN
informal	JJ
informativa	JJ
informativo	JJ
informe	NN
infrarroja	JJ
infrarrojo	JJ
infundir	VB
ingeniera	NN
ingeniero	NN
ingenua	JJ
ingenuo	JJ
Inglaterra	NNP
inglés	JJ
inglesa	JJ
ingrediente	NN
ingresar	VB
ingreso	NN
inhumana	JJ
inhumano	JJ
iniciación	NN
injusta	JJ
injusticia	NN
injusto	JJ
inmediata	JJ
inmediato	JJ
inmensa	JJ
inmenso	JJ
inmigración	NN
inmigrante	NN
inmigrar	VB
inmoble	JJ
inmóvil	JJ
inmunidad	NN
inocente	JJ
inodoro	NN
inolvidable	JJ
inquieta	JJ
inquietar	VB
inquieto	JJ
inquietud	NN
inscribirse	VB
insecticida	NN
insecto	NN
inseguridad	NN
insensata	NN
insensato	NN
insertar	VB
insignia	NN
insinuar	VB
insípida	JJ
insípido	JJ
inspección	NN
inspiración	NN
inspirar	VB
instalación	NN
instalar	VB
instantánea	JJ
instantáneo	JJ
instante	NN
instar	VB
institución	NN
instrumento	NN
insulina	NN
insultar	VB
insuperable	JJ
integrante	JJ
integridad	NN
intelectual	JJ
inteligente	JJ
intención	NN
intentar	VB
intento	NN
interactiva	JJ
interactivo	JJ
interactuar	VB
interamericana	JJ
interamericano	JJ
intercambiar	VB
intercambio	NN
interceptar	VB
interesante	JJ
interesar	VB
interferir	VB
intergaláctica	JJ
intergaláctico	JJ
interior	JJ
intermedio	NN
intermisión	NN
intermitentes	NNS
interna	NN
internacional	JJ
Internet	NN
internista	NN
interno	NN
interpretación	NN
interpretar	VB
intérprete	NN
interrelacionar	VB
interruptor	NN
intersecarse	VB
intervención	NN
intervenir	VB
íntima	JJ
intimidad	NN
íntimo	JJ
intrépida	JJ
intrépido	JJ
intriga	NN
introducir	VB
inundación	NN
inusual	JJ
invencible	JJ
inventar	VB
inventariar	VB
invento	NN
inversión	NN
inversionista	NN
invertir	VB
investigación	NN
investigar	VB
invierno	NN
invitación	NN
invitada	NN
invitado	NN
invitar	VB
inyección	NN
iodo	NN
iPod	NNP
ir	VB
Irak	NNP
Irán	NNP
Iraq	NNP
iridio	NN
iris	NN
Irlanda	NNP
irlandés	JJ
irlandesa	JJ
ironía	NN
irracional	JJ
irritante	JJ
irrompible	JJ
irse	VB
isla	NN
Islam	NNP
Israel	NNP
Italia	NNP
italiana	JJ
italiano	JJ
iterbio	NN
itrio	NN
izquierda	JJ
izquierdista	JJ
izquierdo	JJ
jabalí	NN
jabalina	NN
jabón	NN
jactarse	VB
jade	NN
jaguar	NN
jalar	VB
jalea	NN
jamás	RB
jamón	NN
Januká	NN
Japón	NNP
japonés	JJ
jarabe	NN
jardín	NN
jardinería	NN
jardinero	NN
jarrón	NN
jaspe	NN
jaula	NN
jazz	NN
jeans	NN
jefa	NN
jefe	NN
jengibre	NN
jeringa	NN
jeroglíficos	NN
jersey	NN
Jesucristo	NNP
jesuita	NN
Jesús	NNP
jícama	NN
jinete	NN
jirafa	NN
jít	NN
jitomate	NN
jonrón	NN
José	NNP
joven	JJ
jóvenes	NNS
joya	NN
joyas	NNS
joyera	NN
joyería	NN
joyero	NN
jubilarse	VB
jubilosa	JJ
jubiloso	JJ
Judaísmo	NNP
judía	JJ
judicial	JJ
judío	JJ
judo	NN
jueves	NN
juez	NN
jugador	NN
jugadora	NN
jugar	VB
jugo	NN
juguete	NN
juguetón	JJ
juguetona	JJ
juiciosa	JJ
juicioso	JJ
julio	NN
junio	NN
juntar	VB
Júpiter	NNP
jurado	NN
jurar	VB
jurásica	JJ
jurásico	JJ
justa	JJ
justicia	NN
justo	JJ
juventud	NN
juzgar	VB
kaki	JJ
kilogramo	NN
kilometraje	NN
kilómetro	NN
kinder	NN
kindergarten	NN
kiwi	NN
koala	NN
kryptón	NN
kryptonita	NN
la	DT
labio	NN
labios	NN
laboratorio	NN
labrador	NN
labradora	NN
lacónica	JJ
lacónico	JJ
lactosa	NN
ladera	NN
ladrar	VB
ladrido	NN
ladrillo	NN
ladrón	NN
ladrona	NN
lagartija	NN
lagarto	NN
lago	NN
laguna	NN
lamentación	NN
lamentar	VB
lamer	VB
laminar	VB
lámpara	NN
lana	NN
langosta	NN
lantano	NN
lanza	NN
lanzador	NN
lanzadora	NN
lanzar	VB
lápiz	NN
larga	JJ
largo	JJ
las	DT
láser	NN
lástima	NN
lastimar	VB
lata	NN
látigo	NN
latitud	NN
latón	NN
lava	NN
lavadero	NN
lavadora	NN
lavanda	NN
lavaplatos	NN
lavar	VB
lazada	NN
lazo	NN
leal	JJ
lección	NN
leche	NN
lechuga	NN
lechuza	NN
lectura	NN
leer	VB
legado	NN
legión	NN
legislador	NN
legisladora	NN
legislativa	JJ
legislativo	JJ
lejana	JJ
lejano	JJ
lejos	JJ
leña	NN
lengua	NN
leño	NN
lenta	JJ
lentes	NNS
lento	JJ
leo	NN
león	NN
leopardo	NN
letal	JJ
letra	NN
letrero	NN
levantamiento	NN
levantarse	VB
leve	JJ
ley	NN
leyenda	NN
libélula	NN
libertad	NN
libra	NN
librería	NN
libro	NN
líder	NN
liderazgo	NN
liebre	NN
lienzo	NN
liga	NN
ligamento	NN
ligera	JJ
ligero	JJ
lijar	VB
lila	NN
limbo	NN
limitación	NN
límite	NN
limón	NN
limonada	NN
limpia	JJ
limpiaparabrisas	NN
limpiar	VB
limpio	JJ
limusina	NN
linaje	NN
lince	NN
línea	NN
lino	NN
linterna	NN
lío	NN
liquidación	NN
lirio	NN
lisa	JJ
liso	JJ
lista	JJ
listo	JJ
literalmente	RB
literaria	JJ
literária	JJ
literario	JJ
literário	JJ
literatura	NN
litigio	NN
litio	NN
litografía	NN
llamar	VB
llamativa	JJ
llamativo	JJ
llanta	NN
llanura	NN
llave	NN
llavero	NN
llegar	VB
llenar	VB
llevar	VB
llorar	VB
llover	VB
lluvia	NN
lluviosa	JJ
lluvioso	JJ
loba	NN
lobo	NN
lóbulo	NN
loca	JJ
local	JJ
localizar	VB
loco	JJ
locutor	NN
locutora	NN
lodo	NN
logo	NN
logotipo	NN
lograr	VB
lombrices	NN
lombriz	NN
lona	NN
longitud	NN
loro	NN
los	DT
losa	NN
lotería	NN
lucha	NN
luchar	VB
lucir	VB
luego	RB
lugar	NN
luge	NN
lúgubre	JJ
lujo	NN
lujuria	NN
luminiscente	JJ
Luna	NNP
lunar	NN
lunes	NN
lustre	NN
lutecio	NN
luto	NN
luz	NN
macarrones	NN
macarrónica	JJ
macarrónico	JJ
machete	NN
machismo	NN
machista	NN
madera	NN
madrastra	NN
madre	NN
madrina	NN
madrugar	VB
madura	JJ
maduro	JJ
maestra	NN
maestría	NN
maestro	NN
maga	NN
magia	NN
mágica	JJ
mágico	JJ
magnesio	NN
magnética	JJ
magnético	JJ
magnífica	JJ
magnífico	JJ
mago	NN
mahierba	NN
maíz	NN
mala	JJ
maldecir	VB
maleducada	JJ
maleducado	JJ
maleta	NN
maletero	NN
maletín	NN
malgastar	VB
maligna	JJ
maligno	JJ
malla	NN
malo	JJ
malsana	JJ
malsano	JJ
malvavisco	NN
mambo	NN
mamey	NN
mamut	NN
manada	NN
mañana	NN
manatí	NN
mancha	NN
manchar	VB
mandar	VB
mandarina	NN
mandil	NN
manejar	VB
manera	NN
manga	NN
manganeso	NN
mango	NN
manguera	NN
maní	NN
manicomio	NN
manifestación	NN
maniobra	NN
maniobrar	VB
manipular	VB
mano	NN
manta	NN
mantel	NN
mantener	VB
mantequilla	NN
mantis	NN
manual	JJ
manubrio	NN
manzana	NN
mapa	NN
mapache	NN
maqueta	NN
maquillaje	NN
maquillarse	VB
maquinaria	NN
mar	NN
maraca	NN
maratón	NN
maravilla	NN
maravillarse	VB
maravillosa	JJ
maravilloso	JJ
marca	NN
marcador	NN
marcar	VB
marcha	NN
mareada	JJ
mareado	JJ
marearse	VB
marfil	NN
margarita	NN
margen	NN
María	NNP
marida	NN
marido	NN
marijuana	NN
marimacho	NN
marimba	NN
marina	NN
mariposa	NN
mariquita	NN
mariscos	NN
mármol	NN
marrón	JJ
marrón claro	JJ
martes	NN
martillear	VB
martillo	NN
martini	NN
mártir	NN
marxista	NN
marzo	NN
más	JJ
Masa	NNP
masaje	NN
masajear	VB
mascar	VB
máscara	NN
mascarada	NN
mascota	NN
masculina	JJ
masculino	JJ
masticar	VB
mástil	NN
matadero	NN
matar	VB
mate	NN
matemáticas	NN
materia	NN
maternidad	NN
matón	NN
matona	NN
matrícula	NN
matricular	VB
matrimonio	NN
máxima	JJ
máximo	JJ
mayas	NN
mayo	NN
mayonesa	NN
mayor	JJ
mayordomo	NN
mayoría	NN
me	PRP
mean	NN
mear	VB
mecánica	NN
mecánico	NN
mecate	NN
mechero	NN
medalla	NN
media	NN
medialuna	NN
mediana	JJ
mediano	JJ
medianoche	NN
médica	NN
medicina	NN
medición	NN
médico	NN
medida	NN
medio	RB
mediocampista	NN
mediodía	NN
medir	VB
medusa	NN
mejilla	NN
mejor	JJ
mejorando	RB
mejorar	VB
melodía	NN
melón	NN
membrana	NN
memoria	NN
memorizar	VB
mencionar	VB
mendigar	VB
menear	VB
meneo	NN
menor	JJ
menos	IN
mensaje	NN
mensajera	NN
mensajero	NN
menta	NN
mente	NN
mentir	VB
mentón	NN
menú	NN
mera	JJ
meramente	RB
mercadear	VB
mercadeo	NN
mercado	NN
Mercurio	NNP
merecer	VB
merendar	VB
merengue	NN
merienda	NN
mero	JJ
mes	NN
mesa	NN
mesera	NN
mesero	NN
meseta	NN
meta	NN
metabolismo	NN
metano	NN
meteorito	NN
meteoro	NN
meter	VB
meticulosa	JJ
meticuloso	JJ
método	NN
metro	NN
mexicana	JJ
mexicano	JJ
México	NNP
mezcla	NN
mezclar	VB
mezclilla	NN
mezquita	NN
mi	PRP$
mía	NN
microbio	NN
microbiología	NN
microchip	NN
micrófono	NN
microondas	NN
microscópica	JJ
microscópico	JJ
microscopio	NN
miel	NN
miembra	NN
miembro	NN
mientras	RB
miércoles	NN
mil	JJ
milagro	NN
milenio	NN
militar	JJ
milla	NN
milpiés	NN
mimbre	NN
mina	NN
mineral	JJ
minería	NN
minifalda	NN
mínima	JJ
mínimo	JJ
ministra	NN
ministro	NN
minoría	NN
minuto	NN
mío	NN
miopía	NN
mirar	VB
mirlo	NN
mis	PRP$
misa	NN
misericordia	NN
misión	NN
misionera	NN
misionero	NN
misma	JJ
mismo	JJ
misterio	NN
misteriosa	JJ
misterioso	JJ
mística	JJ
místico	JJ
mitad	NN
mito	NN
mitología	NN
mocasín	NN
mochila	NN
mochilear	VB
moco	NN
moda	NN
modales	NNS
modelar	VB
modelo	NN
modem	NN
moderna	JJ
moderno	JJ
modesta	JJ
modesto	JJ
modismo	NN
modo	NN
mofeta	NN
mofle	NN
moho	NN
mojada	JJ
mojado	JJ
molde	NN
moldeador	NN
mole	NN
molécula	NN
molesta	JJ
molestar	VB
molesto	JJ
molibdeno	NN
mollete	NN
momento	NN
monarca	NN
monasterio	NN
mondar	VB
moneda	NN
monitor	NN
monitora	NN
monja	NN
monje	NN
mono	NN
monopatín	NN
monopolizar	VB
monoteísmo	NN
monoteísta	JJ
monstruo	NN
montaje	NN
montaña	NN
montar a caballo	VB
montar en bicicleta	VB
montar en triciclo	VB
montón	NN
montura	NN
moradura	NN
moral	JJ
morder	VB
morena	JJ
moreno	JJ
morfina	NN
morir	VB
mormón	NN
mormóna	NN
morro	NN
morsa	NN
mortal	JJ
mortificar	VB
mosca	NN
mosquito	NN
mostaza	NN
mostrador	NN
mostrar	VB
moto acuática	NN
motocicleta	NN
motor	NN
motosierra	NN
mover	VB
móvil	JJ
movimiento	NN
MP3	NNP
mucha	JJ
muchacha	NN
muchacho	NN
mucho	JJ
mucosidad	NN
mudarse	VB
mudo	JJ
muebles	NNS
muela	NN
muelas	NNS
muerta	JJ
muerte	NN
muerto	JJ
muestra	NN
mugre	NN
mujer	NN
mula	NN
mulata	JJ
mulato	JJ
mulatos	NNS
muleta	NN
muletas	NNS
multa	NN
multicultural	JJ
multiplicación	NN
multiplicar	VB
mundial	JJ
mundo	NN
muñeca	NN
muñeco	NN
muñequera	NN
mural	NN
murciélago	NN
murmullo	NN
murmurar	VB
músculo	NN
museo	NN
musgo	NN
música	NN
músico	NN
muslo	NN
musulmán	JJ
musulmana	JJ
muy	JJ
nacer	VB
nacimiento	NN
nacional	JJ
nacionalizar	VB
nacionalizarse	VB
nada	RB
nadar	VB
náhuatl	NN
nalga	NN
ñame	NN
napalm	NN
naranja	NN
naranjo	NN
narciso	NN
narcotráfico	NN
nariz	NN
narrador	NN
narradora	NN
natación	NN
Natividad	NNP
natural	JJ
naturaleza	NN
navaja	NN
naval	JJ
nave	NN
navegar	VB
Navidad	NNP
nazi	JJ
neblina	NN
necesidad	NN
necesitar	VB
negar	VB
negativa	JJ
negativo	JJ
negociación	NN
negociar	VB
negocio	NN
negocios	NNS
negra	JJ
negro	JJ
neoclásica	JJ
neoclásico	JJ
neodimio	NN
neón	NN
neoyorquina	NN
neoyorquino	NN
Neptuno	NNP
nervio	NN
nerviosa	JJ
nervioso	JJ
neumático	NN
neutrón	NN
nevar	VB
Nicaragua	NNP
nicaragüense	JJ
nicho	NN
niebla	NN
nieta	NN
nieto	NN
nieve	NN
nilón	NN
niña	NN
niñera	NN
niñero	NN
niñez	NN
ninguna	JJ
ninguno	JJ
ninja	NN
niño	NN
niobio	NN
níquel	NN
nitrato	NN
nitrógeno	NN
nivel	NN
noche	NN
nocturna	JJ
nocturno	JJ
nódulo	NN
nogal	NN
nombrar	VB
nombre	NN
nopal	NN
nordeste	NN
noreste	NN
normal	JJ
normalmente	RB
noroeste	NN
norte	NN
Norteamérica	NNP
norteamericana	JJ
norteamericano	JJ
nos	PRP
nostalgia	NN
nota	NN
noticia	NN
noticias	NNS
noticiero	NN
novata	NN
novato	NN
novecientas	JJ
novecientos	JJ
novela	NN
novelesca	JJ
novelesco	JJ
novelista	NN
novena	JJ
noveno	JJ
noventa	JJ
novia	NN
noviembre	NN
novio	NN
novios	NNS
nube	NN
nubosa	JJ
nuboso	JJ
nuclear	JJ
núcleo	NN
nudillo	NN
nudo	NN
nuera	NN
nuestra	JJ
nuestro	JJ
nueva	JJ
nueve	JJ
nuevo	JJ
nuez	NN
número	NN
número decimal	NN
numerosa	JJ
numeroso	JJ
nunca	RB
nutria	NN
nutrición	NN
nutrir	VB
nutritiva	JJ
nutritivo	JJ
o	CC
oasis	NN
obedecer	VB
obediente	JJ
obesa	JJ
obeso	JJ
objectivo	NN
objetiva	JJ
objetivo	JJ
objeto	NN
obligarse	VB
obligatoria	JJ
obligatorio	JJ
oboe	NN
obra	NN
obrero	NN
observatorio	NN
obsesión	NN
obstáculo	NN
obstetra	NN
obstruir	VB
obtener	VB
obtusa	JJ
obtuso	JJ
obviamente	RB
ocasión	NN
occidental	JJ
océano	NN
ochenta	JJ
ocho	JJ
ochocientas	JJ
ochocientos	JJ
octágono	NN
octava	JJ
octavo	JJ
octubre	NN
oculta	JJ
ocultar	VB
oculto	JJ
ocupación	NN
ocupada	JJ
ocupado	JJ
ocupar	VB
ocurrir	VB
odiar	VB
odio	NN
odiosa	JJ
odioso	JJ
odisea	NN
oeste	NN
ofensiva	JJ
ofensivo	JJ
oficial	JJ
oficina	NN
ofrecer	VB
ofrenda	NN
oftamóloga	NN
oftamólogo	NN
oído	NN
oír	VB
ojo	NN
ola	NN
óleo	NN
oler	VB
olímpica	JJ
olímpico	JJ
oliva	NN
olla	NN
olmo	NN
olor	NN
olvidarse	VB
ombligo	NN
once	JJ
onceava	JJ
onceavo	JJ
oncologista	NN
onda	NN
onomatopoeia	NN
onza	NN
ópalo	NN
operación	NN
operador	NN
operadora	NN
operar	VB
opinión	NN
oponer	VB
oportuna	JJ
oportunidad	NN
oportuno	JJ
opresión	NN
optar	VB
óptica	JJ
óptico	JJ
optimista	NN
opuesta	NN
oración	NN
orador	NN
oradora	NN
orangután	NN
orar	VB
órbita	NN
orden	NN
ordenada	JJ
ordenado	JJ
ordenador	NN
ordenar	VB
ordinaria	JJ
ordinario	JJ
orégano	NN
oreja	NN
orejera	NN
orfanato	NN
orgánica	JJ
orgánico	JJ
organización	NN
organizador	NN
organizadora	NN
organizar	VB
órgano	NN
orgullo	NN
orgullosa	JJ
orgulloso	JJ
oriental	JJ
origen	NN
orilla	NN
orina	NN
orinar	VB
ornamento	NN
ornitorrinco	NN
oro	NN
orquesta	NN
orquídea	NN
ortografía	NN
ortopedista	NN
oruga	NN
oscilar	VB
oscura	JJ
oscuro	JJ
osmio	NN
oso	NN
ostra	NN
otoño	NN
otorrinolaringóloga	NN
otorrinolaringólogo	NN
otra	JJ
otro	JJ
out	NN
ovación	NN
ovalada	JJ
ovalado	JJ
óvalo	NN
ovario	NN
oveja	NN
overoles	NNS
oxidarse	VB
óxido	NN
oxígeno	NN
oyente	NN
ozono	NN
pabellón	NN
pabilo	NN
pacana	NN
paciencia	NN
paciente	JJ
pacífica	JJ
pacífico	JJ
pacto	NN
padrastro	NN
padre	NN
padres	NNS
padrino	NN
paella	NN
pagar	VB
página	NN
pago	NN
país	NN
paisaje	NN
paja	NN
pajarilla	NN
pájaro	NN
pala	NN
palabra	NN
palacio	NN
paladín	NN
paladio	NN
palanca	NN
palangana	NN
palé	NN
palear	VB
palet	NN
paleta	NN
palito	NN
palma	NN
palmera	NN
palo	NN
paloma	NN
palpitante	JJ
palpitar	VB
pan	NN
pana	NN
panadera	NN
panadería	NN
panadero	NN
pañal	NN
Panamá	NNP
panameña	JJ
panameño	JJ
páncreas	NN
panda	NN
pandereta	NN
pandilla	NN
panecillo	NN
panorama	NN
panqueque	NN
pantalgigante	NN
pantalla	NN
pantalones	NNS
pantera	NN
pantimedias	NNS
pantorrilla	NN
pañuelo	NN
panza	NN
papa	NN
papagayo	NN
papalote	NN
papel	NN
paperas	NNS
paphigiénico	NN
paquete	NN
par	JJ
parábola	NN
parabrisas	NN
paracaídas	NN
parachoques	NN
paraguas	NN
Paraguay	NNP
paraguaya	JJ
paraguayo	JJ
paralela	JJ
paralelo	JJ
paralelogramo	NN
paralizar	VB
paranoica	JJ
paranoico	JJ
parapetar	VB
parar	VB
parcial	JJ
parcialidad	NN
parecer	VB
pared	NN
pareja	NN
paréntesis	NN
parienta	NN
pariente	NN
parilla	NN
parir	VB
parlante	NN
párpado	NN
parque	NN
parrillada	NN
parte	NN
partera	NN
participar	VB
particularmente	RB
partido	NN
partir	VB
parto	NN
parvada	NN
pasable	JJ
pasadera	JJ
pasadero	JJ
pasaje	NN
pasajera	NN
pasajero	NN
pasamanos	NN
pasaporte	NN
pasatiempo	NN
Pascua	NNP
pasear	VB
paseo	NN
pasillo	NN
pasión	NN
pasiva	JJ
pasivo	JJ
paso	NN
pasos	NNS
pasta	NN
pastar	VB
pastel	JJ
pastelería	NN
pasteurizar	VB
pastilla	NN
pasto	NN
pastor	NN
pastora	NN
patada	NN
patear	VB
patentar	VB
patente	NN
paternidad	NN
patín	NN
patinar	VB
patinete	NN
patio	NN
pato	NN
patria	NN
patriótica	JJ
patriótico	JJ
patrocinador	NN
patrocinadora	NN
patrocinar	VB
patrocinio	NN
patrón	NN
patrona	NN
patrono	NN
patrulla	NN
pausa	NN
pauta	NN
pautar	VB
pavimento	NN
pavo	NN
payaso	NN
paz	NN
peaje	NN
peatón	NN
peca	NN
pecado	NN
pecador	NN
pecadora	NN
pecar	VB
pecho	NN
pecosa	JJ
pecoso	JJ
pedal	NN
pedante	JJ
pedazo	NN
pederse	VB
pediatra	NN
pedido	NN
pedir	VB
pedo	NN
pegajosa	JJ
pegajoso	JJ
pegamento	NN
pegar	VB
pegatina	NN
peinarse	VB
peine	NN
peldaño	NN
pelearse	VB
pelícucómica	NN
pelícudocumental	NN
pelícudoeste	NN
película	NN
pelícumusical	NN
pelícupolicíaca	NN
pelícuromántica	NN
peligro	NN
peligrosa	JJ
peligroso	JJ
peliguey	NN
pelirroja	JJ
pelirrojo	JJ
pellejo	NN
pelo	NN
pelota	NN
pelotera	NN
pelotero	NN
peluca	NN
peluda	JJ
peludo	JJ
peluquín	NN
pelusa	NN
pena	NN
peña	NN
pendiente	JJ
pendón	NN
péndulo	NN
penicilina	NN
península	NN
pensamiento	NN
pensar	VB
pensión	NN
pentágono	NN
pentatlón	NN
penuria	NN
peor	JJ
pepinillo	NN
pepino	NN
pequeña	JJ
pequeñín	JJ
pequeñina	JJ
pequeño	JJ
pera	NN
peral	NN
percepción	NN
percha	NN
percibir	VB
perdedor	NN
perdedora	NN
perder	VB
perdida	JJ
pérdida	NN
perdido	JJ
perdiz	NN
perdonar	VB
peregrina	NN
peregrino	NN
perejil	NN
pereza	NN
perezosa	JJ
perezoso	JJ
perfección	NN
perfeccionista	JJ
perfecta	JJ
perfecto	JJ
perfil	NN
perfume	NN
peridoto	NN
perilla	NN
periódica	JJ
periódico	JJ
periodista	NN
período	NN
periquito	NN
perla	NN
permanecer	VB
permanente	JJ
permitir	NN
pero	CC
perpendicular	JJ
perpetrador	NN
perpetradora	NN
perpetuar	VB
perpetuidad	NN
perpleja	JJ
perplejo	JJ
perrito	NN
perro	NN
perseguir	VB
perseverancia	NN
pérsica	JJ
pérsico	JJ
persona	NN
personaje	NN
personal	JJ
personificar	VB
perspectiva	NN
perspicacia	NN
perspicaz	JJ
pertenecer	VB
Perú	NNP
peruana	JJ
peruano	JJ
perversa	JJ
perverso	JJ
pesar	VB
pesas	NNS
pescadería	NN
pescado	NN
pescar	VB
pesebre	NN
pésima	JJ
pesimista	JJ
pésimo	JJ
peso	NN
pestaña	NN
petardo	NN
petición	NN
petirrojo	NN
petróleo	NN
pez	NN
pezón	NN
piadosa	JJ
piadoso	JJ
pianista	NN
piano	NN
picaflor	NN
picante	JJ
picaporte	NN
picar	VB
pícara	JJ
pícaro	JJ
picarse	VB
piccolo	NN
picea	NN
picor	NN
picosa	JJ
picoso	JJ
pie	NN
piedra	NN
piel	NN
pierna	NN
pieza	NN
pijama	NN
pila	NN
píldora	NN
pillaje	NN
piloto	NN
pimienta	NN
pimiento	NN
piña	NN
pinar	NN
pincel	NN
pinchazo	NN
pingüino	NN
pino	NN
Pinocho	NNP
piñón	NN
pinta	JJ
pintar	VB
pinto	JJ
pintor	NN
pintora	NN
pintoresca	JJ
pintoresco	JJ
pintorrear	VB
pintura	NN
pinzas	NNS
pionera	NN
pionero	NN
piragüismo	NN
pirámide	NN
pirata	NN
pis	NN
piscina	NN
piscis	NN
piso	NN
pisotear	VB
pista	NN
pistolera	NN
pistolero	NN
pistón	NN
pito	NN
piyama	NN
pizarra	NN
pizote	NN
pizza	NN
placa	NN
plácida	JJ
plácido	JJ
plaga	NN
plana	JJ
planchar	VB
planear	VB
planeta	NN
planetario	NN
plano	JJ
planta	NN
plantilla	NN
plasticina	NN
plástico	NN
plata	NN
plataforma	NN
plátano	NN
plateada	JJ
plateado	JJ
platillo	NN
platino	NN
plato	NN
playa	NN
plaza	NN
plazo	NN
plegar	VB
pleito	NN
plétora	NN
plomera	NN
plomero	NN
plomo	NN
pluma	NN
plural	JJ
Plutón	NNP
plutonio	NN
población	NN
poblador	NN
pobladora	NN
poblar	VB
pobres	NNS
pobreza	NN
pocha	NN
pocho	NN
poco	JJ
poder	VB
poderosa	JJ
poderoso	JJ
podio	NN
podrida	JJ
podrido	JJ
poema	NN
poemario	NN
poesía	NN
poeta	NN
polaca	NN
polaco	NN
polar	JJ
polea	NN
polen	NN
policía	NN
poligamia	NN
polígono	NN
polilla	NN
politeísmo	NN
política	JJ
político	JJ
pollera	NN
pollo	NN
Polonia	NNP
polonio	NN
polvo	NN
pomo	NN
pompa	NN
poner	VB
poni	NN
póquer	NN
por	IN
porcelana	NN
porcentaje	NN
porque	CC
porquería	NN
portaaviones	NN
portada	NN
portátil	JJ
portera	NN
portería	NN
portero	NN
portorriqueña	JJ
portorriqueño	JJ
posavasos	NN
poseer	VB
posesión	NN
posibilidad	NN
posible	JJ
posición	NN
positiva	JJ
positivo	JJ
posmoderna	JJ
posmoderno	JJ
poste	NN
posteriormente	RB
postre	NN
postular	VB
postura	NN
potasio	NN
potente	JJ
potra	NN
potro	NN
poza	NN
pozo	NN
práctica	JJ
practicable	JJ
practicar	VB
práctico	JJ
pradera	NN
prado	NN
praseodimio	NN
preciada	JJ
preciado	JJ
precio	NN
preciosa	JJ
precioso	JJ
precipicio	NN
precipitado	NN
precipitar	VB
precolombina	JJ
precolombino	JJ
predecir	VB
predestinación	NN
predicador	NN
predicadora	NN
predicar	VB
preescolar	JJ
preferida	JJ
preferido	JJ
preferir	VB
pregón	NN
pregunta	NN
preguntar	VB
prematura	JJ
prematuro	JJ
premiar	VB
premio	NN
prenda	NN
prensa	NN
preocupación	NN
preocupar	VB
presa	NN
presagiar	VB
presentar	VB
presente	NN
presidenta	NN
presidente	NN
presión	NN
presión arterial	NN
preso	NN
préstamo	NN
prestar	VB
presupuesto	NN
prevenir	VB
previsible	JJ
prima	NN
primavera	NN
primer	JJ
primera	JJ
primitiva	JJ
primitivo	JJ
primo	NN
princesa	NN
principal	JJ
principalmente	RB
príncipe	NN
principiante	NN
principio	NN
pringue	NN
prioridad	NN
prisa	NN
prisión	NN
prisionera	NN
prisionero	NN
prisma	NN
privacidad	NN
privada	JJ
privado	JJ
proa	NN
probable	JJ
probablemente	RB
probar	VB
problema	NN
problemas	NNS
procedimiento	NN
proceso	NN
proclamación	NN
proclividad	NN
producción	NN
producir	VB
productiva	JJ
productivo	JJ
producto	NN
profesión	NN
profesional	JJ
profesor	NN
profesora	NN
profeta	NN
profunda	JJ
profundo	JJ
progenie	NN
programa	NN
programar	VB
prohibición	NN
prohibir	VB
prole	NN
promecio	NN
prometer	VB
promover	VB
promulgar	VB
pronombre	NN
pronunciación	NN
pronunciar	VB
propano	NN
propiamente	RB
propicia	JJ
propicio	JJ
propiedad	NN
propina	NN
proponer	VB
proporcionar	VB
propugnar	VB
protactinio	NN
protagonista	NN
protagonizar	VB
proteger	VB
proteína	NN
protestante	NN
protestantismo	NN
protestar	VB
protón	NN
provecho	NN
providencia	NN
provincia	NN
provisión	NN
provocar	VB
próxima	NN
próximo	NN
proyección	NN
proyectil	NN
proyecto	NN
proyector	NN
prueba	NN
psicoanálisis	NN
psicoanalista	NN
psiquiatra	NN
púa	NN
publicar	VB
público	NN
pudín	NN
pueblo	NN
puente	NN
puercoespín	NN
puerta	NN
pues	CC
puesto	NN
pulga	NN
pulgada	NN
pulir	VB
pulmón	NN
pulmonía	NN
púlpito	NN
pulpo	NN
pulsera	NN
pulverizador	NN
puma	NN
puñado	NN
puñal	NN
puño	NN
punta	NN
puntada	NN
puntadas	NNS
puntapié	NN
punto	NN
puntuación	NN
puntualidad	NN
puntualmente	RB
puntuar	VB
pupila	NN
pupitre	NN
que	CC
qué	WP
quechua	NN
quedar	VB
queja	NN
quejarse	VB
quema	NN
quemador	NN
quemarse	VB
quesadilla	NN
queso	NN
quiché	NN
quién	WP
química	NN
químico	NN
quitar	VB
rábano	NN
rabia	NN
rabo	NN
radar	NN
radiactividad	NN
radiador	NN
radio	NN
radiografía	NN
radón	NN
ráfaga	NN
raíz	NN
rama	NN
rana	NN
ranura	NN
rapera	NN
rapero	NN
rapidez	NN
raqueta	NN
rascacielos	NN
rascar	VB
rasgar	VB
rasgo	NN
rasguear	VB
rasguño	NN
rastrillar	VB
rastrillo	NN
rata	NN
ratón	NN
raya	NN
rayar	VB
rayo	NN
raza	NN
razón	NN
razonar	VB
reabastecer	VB
reacción	NN
realismo	NN
reanudar	VB
rebaja	NN
rebaño	NN
rebelarse	VB
rebobinar	VB
rebotar	VB
rebote	NN
recado	NN
recambio	NN
recapacitar	VB
recepción	NN
recepcionista	NN
receptor	NN
receptora	NN
recesión	NN
receta	NN
recetar	VB
rechazar	VB
rechazo	NN
recibir	VB
recibo	NN
reciclaje	NN
reciclar	VB
recientemente	RB
recipiente	NN
recitar	VB
reclamo	NN
recluta	NN
reclutar	VB
recluto	NN
recoger	VB
recomendación	NN
recomendar	VB
reconocer	VB
reconocimiento	NN
reconquistar	VB
recordar	VB
recorrido	NN
recorte	NN
recreo	NN
rectángulo	NN
recto	RB
recuadro	NN
recuerdo	NN
recuperar	VB
recurrir	VB
recurso	NN
red	NN
redacción	NN
redactor	NN
redactora	NN
redención	NN
redimir	VB
reducir	VB
reembolsar	VB
reembolso	NN
reflejo	NN
reflexionar	VB
refrescar	VB
refresco	NN
refrigerador	NN
refugiada	NN
refugiado	NN
refugio	NN
regalar	VB
regaliz	NN
regalo	NN
regar	VB
regatear	VB
reggae	NN
régimen	NN
región	NN
registrar	VB
registro	NN
regla	NN
reglar	VB
regresar	VB
rehacer	VB
rehén	NN
rehuir	VB
reina	NN
reinado	NN
reincidir	VB
reintentar	VB
reírse	VB
reja	NN
relación	NN
relacionar	VB
relajarse	VB
relámpago	NN
relámpagos	NNS
relativamente	RB
relato	NN
relevar	VB
relevarse	VB
relevo	NN
religión	NN
relinquir	VB
relleno	NN
reloj	NN
remar	VB
remedio	NN
remitente	NN
remo	NN
remordimiento	NN
renacimiento	NN
renacuajo	NN
rendimiento	NN
rendir	VB
renio	NN
reno	NN
reparar	VB
repartidor	NN
repartidora	NN
repartir	VB
repasar	VB
repelar	VB
repelente	NN
repetir	VB
repollo	NN
reportaje	NN
reposer	VB
representación	NN
representante	NN
representar	VB
represión	NN
republicana	NN
republicano	NN
reputación	NN
requerir	VB
requisito	NN
resbalar	VB
rescatar	VB
rescate	NN
reserva	NN
reservación	NN
reservar	VB
resfriado	NN
resfriarse	VB
residuo	NN
resolver	VB
resonar	VB
respetar	VB
respiración	NN
respiradero	NN
respirar	VB
respiro	NN
resplandecer	VB
resplandor	NN
responder	VB
responsabilidad	NN
respuesta	NN
resta	NN
restar	VB
restauración	NN
restaurante	NN
restaurar	VB
resto	NN
restos	NNS
restricción	NN
resucitar	VB
resultado	NN
resultar	VB
resumen	NN
resurrección	NN
retenedor	NN
retener	VB
retirar	VB
retirarse	VB
reto	NN
retractar	VB
retraso	NN
retrato	NN
reunión	NN
reunir	VB
reutilizar	VB
revelista	NN
reverencia	NN
revista	NN
revistero	NN
revivir	VB
revolución	NN
revolver	VB
rey	NN
rezar	VB
rezumar	VB
riachuelo	NN
ridiculizar	VB
rifle	NN
rima	NN
rimar	VB
rímel	NN
rinoceronte	NN
riñón	NN
río	NN
risa	NN
risita	NN
ritmo	NN
rizo	NN
róbalo	NN
robar	VB
roble	NN
robo	NN
robot	NN
roca	NN
rociar	VB
rocío	NN
rock	NN
rodar	VB
rodear	VB
rodeo	NN
rodilla	NN
rodillera	NN
rodio	NN
roedor	NN
rollo	NN
Romántico	NN
rombo	NN
romperse	VB
ropa	NN
rosa	NN
rostro	NN
rotar	VB
rotulador	NN
rubí	NN
rubidio	NN
rueda	NN
ruido	NN
ruinas	NNS
rumba	NN
rumbo	NN
rumiar	VB
Rusia	NNP
rutenio	NN
rutina	NN
sábado	NN
sábana	NN
sabelotodo	NN
saber	VB
sabiduría	NN
sabueso	NN
sacapuntas	NN
sacar	VB
sacerdote	NN
sacrificar	VB
sacrificio	NN
sacudir	VB
safari	NN
sagitario	NN
sal	NN
sala	NN
salario	NN
salida	NN
salir	VB
salitre	NN
salmón	NN
salpicadura	NN
salsa	NN
saltamontes	NN
saltar	VB
saltear	VB
saltito	NN
salto	NN
saltos	NNS
salud	NN
saludar	VB
salvación	NN
salvar	VB
salvavidas	NN
samario	NN
samba	NN
samurái	NN
sanar	VB
sanción	NN
sandalia	NN
sandía	NN
sandwich	NN
sangrar	VB
sangre	NN
santa	NN
santificación	NN
santificar	VB
santo	NN
santuario	NN
sapo	NN
saquear	VB
saqueo	NN
sarampión	NN
sarcasmo	NN
sardina	NN
sarpullido	NN
sartén	NN
sastre	NN
satélite	NN
satín	NN
satirizar	VB
satisfacer	VB
Saturno	NNP
saxofón	NN
saxofonista	NN
se	PRP
secadora	NN
secar	VB
sección	NN
secretar	VB
secretaria	NN
secretario	NN
secreto	NN
secta	NN
secuestrar	VB
secuestro	NN
seda	NN
sedante	NN
sede	NN
segregación	NN
seguidor	NN
seguidora	NN
seguir	VB
según	CC
segundo	NN
seguramente	RB
seguridad	NN
seguro	NN
seleccionar	VB
selenio	NN
sellar	VB
sello	NN
selva	NN
semáforo	NN
semana	NN
sembrar	VB
semestre	NN
semiesfera	NN
seminario	NN
Senado	NNP
senador	NN
senadora	NN
señalador	NN
señalar	VB
sencillez	NN
senda	NN
sendero	NN
señor	NN
sensor	NN
sentarse	VB
sentencia	NN
sentimiento	NN
sentirse	VB
señuelo	NN
separar	VB
separarse	VB
septiembre	NN
sepultar	VB
sequía	NN
ser	VB
serie	NN
serpentear	VB
serpentina	NN
serpiente	NN
serrín	NN
serrucho	NN
servicio	NN
servicios	NNS
servidor	NN
servidora	NN
servilleta	NN
servir	VB
seto	NN
seudónimo	NN
sexo	NN
shorts	NNS
si	CC
sí	RB
sicario	NN
sicoanálisis	NN
sicoanalista	NN
sidra	NN
siembra	NN
siempre	RB
sierra	NN
siesta	NN
sigla	NN
siglo	NN
significado	NN
significar	VB
sil	NN
sílaba	NN
silbar	VB
silbato	NN
silbido	NN
silenciador	NN
sílice	NN
silla	NN
sillón	NN
siluro	NN
simbolizar	VB
símbolo	NN
simplicidad	NN
sin	IN
sinagoga	NN
sinceramente	RB
sindicato	NN
sinfín	NN
sinnúmero	NN
sino	CC
sinsonte	NN
síntoma	NN
siquiera	RB
sitio	NN
situación	NN
situar	VB
skeleton	NN
snowboard	NN
sobaco	NN
soberana	NN
soberano	NN
sobre	IN
sobrecama	NN
sobreestimar	VB
sobremesa	NN
sobresalir	VB
sobrevivir	VB
sobrina	NN
sobrino	NN
socia	NN
socialista	NN
sociedad	NN
socio	NN
sodio	NN
sofá	NN
sofisticación	NN
softball	NN
software	NN
soga	NN
Sol	NNP
solamente	RB
solapa	NN
soldado	NN
soler	VB
solicitar	VB
solicitud	NN
soliloquio	NN
solista	NN
sollozar	VB
solución	NN
solucionar	VB
sombra	NN
sombrero	NN
sonar	VB
soñar	VB
sonido	NN
sonreír	VB
sonrisa	NN
sopa	NN
soplar	NN
soportar	VB
soprano	NN
sorbete	NN
sorda	NN
sordo	NN
sorprender	VB
sospechosa	NN
sospechoso	NN
sostén	NN
sostener	VB
sótano	NN
sprintar	VB
step	NN
su	PRP$
subconsciente	NN
subestimar	VB
subir	VB
súbitamente	RB
submarino	NN
substituir	VB
subyugar	VB
sucedáneo	NN
sucesión	NN
sucesor	NN
sucesora	NN
sucitar	VB
sucursal	NN
sudadera	NN
Sudamérica	NNP
sudeste	NN
sudoeste	NN
sudor	NN
Suecia	NNP
suegra	NN
suegro	NN
sueldo	NN
suelo	NN
sueño	NN
suerte	NN
suéter	NN
sufrimiento	NN
sufrir	VB
sugerencia	NN
sugerir	VB
suicidarse	VB
sujetapapeles	NN
suma	NN
sumar	VB
sumergir	VB
superar	VB
superficialmente	RB
Superman	NNP
supermercado	NN
supervisor	NN
supervisora	NN
suplicar	VB
suponer	VB
suposición	NN
suprema	VB
supremo	VB
suprimir	VB
supuestamente	RB
sur	NN
Suramérica	NNP
surco	NN
sureste	NN
surgir	VB
suroeste	NN
surrealismo	NN
sus	PRP$
suscribirse	VB
suspender	VB
suspensión	NN
sustancia	NN
sustantivo	NN
sustituta	NN
sustituto	NN
susto	NN
sustracción	NN
susurrar	VB
susurro	NN
suya	PRP$
suyas	PRP$
suyo	PRP$
suyos	PRP$
tabaco	NN
tabladura	NN
tablilla	NN
tabulador	NN
tachuela	NN
tacle	NN
taclear	VB
taco	NN
tacón	NN
taekwondo	NN
taíno	NN
tala	NN
taladradora	NN
taladro	NN
talar	VB
talega	NN
talento	NN
talio	NN
talla	NN
taller	NN
tallo	NN
tamaño	NN
también	RB
tambor	NN
tamborilera	NN
tamborilero	NN
tamborista	NN
tango	NN
tanque	NN
tantalio	NN
tanto	RB
tapa	NN
tapas	NN
tapete	NN
tapicería	NN
tapón	NN
taquilla	NN
taquillera	NN
taquillero	NN
tarántula	NN
tardar	VB
tarde	NN
tarea	NN
tarjeta	NN
tarjetero	NN
tarta	NN
tasa	NN
tatuaje	NN
tatuar	VB
tauro	NN
taxi	NN
taza	NN
tazón	NN
te	PRP
té	NN
teatro	NN
techo	NN
tecla	NN
teclado	NN
teclear	VB
tecnecio	NN
técnica	NN
técnico	NN
tecnología	NN
teja	NN
tejeduría	NN
tejer	VB
tejido	NN
tejón	NN
tela	NN
telar	NN
telaraña	NN
tele	NN
teleférico	NN
telefonear	VB
telegrafiar	VB
telégrafo	NN
telegrama	NN
telenovela	NN
telepatía	NN
televidente	NN
televisar	VB
televisión	NN
televisor	NN
teluro	NN
tema	NN
temática	NN
temblar	VB
temblor	NN
temer	VB
temor	NN
temperamento	NN
tempestad	NN
templo	NN
temporalmente	RB
tendencia	NN
tender	VB
tendinitis	NN
tendón	NN
tenedor	NN
tener	VB
teñir	VB
tenis	NN
tenor	NN
tensar	VB
tensión	NN
teología	NN
teoría	NN
terapia	NN
terbio	NN
terciopelo	NN
terminar	VB
termita	NN
ternera	NN
ternura	NN
terremoto	NN
terrorismo	NN
terrorista	NN
tesis	NN
tesoro	NN
testiga	NN
testigo	NN
tetera	NN
textear	VB
textil	NN
texto	NN
textura	NN
tía	NN
tiburón	NN
tiempo	NN
tienda	NN
tierra	NN
tigre	NN
tijeras	NNS
timbre	NN
timón	NN
tiniebla	NN
tinta	NN
tío	NN
tíos	NNS
tipo	NN
tira	NN
tirana	NN
tirano	NN
tirar	VB
tirita	NN
tiro	NN
tiroteo	NN
titanio	NN
título	NN
tiza	NN
toalla	NN
tobillera	NN
tobillo	NN
tobogán	NN
tocadiscos	NN
tocar	VB
tocino	NN
tocón	NN
toda	RB
todavía	RB
todo	RB
tolerancia	NN
tomacorriente	NN
tomar	VB
tomate	NN
tomillo	NN
tonelada	NN
tono	NN
tontería	NN
tonterías	NN
topacio	NN
tope	NN
topo	NN
torcer	VB
torio	NN
tormenta	NN
tornado	NN
torneo	NN
tornillo	NN
torre	NN
torro	NN
torta	NN
tortilespañola	NN
tortilla	NN
tortuga	NN
tortura	NN
torturar	VB
tos	NN
toser	VB
tostador	NN
tostar	VB
total	NN
touchdown	NN
trabajar	VB
trabajo	NN
tractor	NN
tradición	NN
traducción	NN
traducir	VB
traductor	NN
traductora	NN
traer	VB
tráfico	NN
tragar	VB
tragedia	NN
trago	NN
traición	NN
traicionar	VB
traje	NN
trampa	NN
trampilla	NN
trampolín	NN
transacción	NN
transbordador	NN
transformar	VB
transfusión	NN
transmisión	NN
transparencia	NN
transplantar	VB
transplante	NN
trapeador	NN
trapecio	NN
trapo	NN
trasero	NN
trasladar	VB
tratado	NN
tratamiento	NN
tratar	VB
trato	NN
travesura	NN
trazar	VB
tregua	NN
tren	NN
trenza	NN
trenzar	VB
trepar	VB
triángulo	NN
tribu	NN
triciclo	NN
trigonometría	NN
trinar	VB
trinchar	VB
trinchera	NN
trinchete	NN
trineo	NN
trino	NN
triplicar	VB
triplicarse	VB
tripulación	NN
tripulante	NN
trofeo	NN
trombón	NN
trompeta	NN
trompetista	NN
tronar	VB
tronco	NN
tropezar	VB
trotar	VB
trucha	NN
trueno	NN
truenos	NNS
tu	PRP
tuba	NN
tubo	NN
tulio	NN
tulipán	NN
tumba	NN
tumor	NN
tundra	NN
tungsteno	NN
tupé	NN
turista	NN
turnar	VB
turquesa	NN
Turquía	NNP
tus	PRP$
tutor	NN
tutora	NN
tuya	NN
tuyo	NN
ubicación	NN
últimamente	RB
ultrasonido	NN
un	DT
una	DT
uña	NN
unas	DT
unicornio	NN
unidad	NN
uniforme	NN
unión	NN
unir	VB
universidad	NN
universo	NN
unos	DT
uranio	NN
Urano	NNP
urgir	VB
urna	NN
Uruguay	NNP
usar	VB
usted	PRP
ustedes	PRP
usuario	NN
utilizar	VB
uva	NN
vaca	NN
vacación	NN
vacaciones	NNS
vacada	NN
vacante	NN
vaciar	VB
vacilar	VB
vacío	NN
vacuna	NN
vacunación	NN
vadear	VB
vagar	VB
vagina	NN
vainilla	NN
vajilla	NN
valer	VB
valla	NN
valle	NN
valor	NN
vals	NN
válvula	NN
vampiro	NN
vanadio	NN
vándala	NN
vándalo	NN
vaporizador	NN
vaquera	NN
vaquero	NN
vaqueros	NNS
vara	NN
varicela	NN
varilla	NN
vasija	NN
vaso	NN
vecina	NN
vecindad	NN
vecindario	NN
vecino	NN
vega	NN
vegetariana	NN
vegetariano	NN
vejiga	NN
vela	NN
velcro	NN
vellón	NN
velo	NN
velocidad	NN
vena	NN
venada	NN
venado	NN
vencer	VB
venda	NN
vendedor	NN
vendedora	NN
vender	VB
veneno	NN
venerar	VB
Venezuela	NNP
venir	VB
ventaja	NN
ventana	NN
ventanilla	NN
ventilador	NN
Venus	NNP
ver	VB
verano	NN
verdad	NN
verdaderamente	RB
verdugón	NN
verdulería	NN
verdura	NN
vergüenza	NN
verificación	NN
vernáculo	NN
verruga	NN
verse	VB
versículo	NN
vértebra	NN
vertedero	NN
verter	VB
vesícubiliar	NN
vestíbulo	NN
vestido	NN
vestigio	NN
vestimenta	NN
vestirse	VB
vetar	VB
veterana	NN
veterano	NN
veterinaria	NN
veterinario	NN
veto	NN
vez	NN
vía	NN
viajar	VB
viaje	NN
viajera	NN
viajero	NN
víbora	NN
vicepresidenta	NN
vicepresidente	NN
vicio	NN
víctima	NN
vida	NN
video	NN
videocasetera	NN
videojuego	NN
vidriería	NN
vidrio	NN
viento	NN
viernes	NN
vigilancia	NN
vigilante	NN
vigilar	VB
vigorizar	VB
vikinga	NN
vikingo	NN
villancico	NN
vinagre	NN
vincular	VB
vino	NN
viola	NN
violación	NN
violar	VB
violencia	NN
violeta	NN
violín	NN
violinista	NN
virgen	NN
virgo	NN
virus	NN
virutas	NN
visera	NN
visitante	NN
visitar	VB
víspera	NN
vista	NN
vistazo	NN
visualizar	VB
vitalidad	NN
vitamina	NN
vitrina	NN
viuda	NN
viudo	NN
vivir	VB
volante	NN
volar	VB
vóleibol	NN
vólibol	NN
voltio	NN
volumen	NN
voluntad	NN
volver	VB
volverse	VB
vomitar	VB
vos	PRP
votar	VB
voto	NN
vuelo	NN
vuelta	NN
vulcanizar	VB
wafle	NN
wolframio	NN
Wolverine	NNP
xenófoba	NN
xenofobia	NN
xenófobo	NN
xenón	NN
xilófono	NN
y	CC
ya	RB
yarda	NN
yate	NN
yegua	NN
yerno	NN
yeso	NN
Yeti	NNP
yo	PRP
yoga	NN
yogur	NN
yugo	NN
yuxtaponer	VB
zafiro	NN
zanahoria	NN
zapatería	NN
zapatilla	NN
zapato	NN
zapatos	NNS
zapote	NN
zarandear	VB
zigzaguear	VB
Zimbabue	NNP
Zimbabwe	NNP
zinc	NN
zirconio	NN
zodiaco	NN
zombi	NN
zona	NN
zoológico	NN
zopilote	NN
zorra	NN
zorrillo	NN
zorro	NN
zueco	NN
zumbar	VB
zumo	NN
YouTube	NNP
Apple 	NNP
Peugeot	NNP
Nintendo	NNP
Skype	NNP
Microsoft	NNP
Sony	NNP
Twitter	NNP
Toyota	NNP
Nissan	NNP
's	POS
Tepco	NNP
iWiks	NNP
Santalba	NNP
Bayer	NNP
Wal-mart	NNP
Gensler	NNP
ABC	NNP
google	NNP
super	JJ
agil	JJ
sucio	JJ
