Acceso	Acceso
Accesos	Acceso
Administración	Administración
administracion	Administración
Aire acondicionado	Aire acondicionado
aire acondisionado	Aire acondicionado
Alianza	Alianzas
Alianzas	Alianzas
aliansa	Alianzas
aliansas	Alianzas
ampliacion	Ampliación
ampliasion	Ampliación
Ampliación	Ampliación
Anfitriona	Anfitriona
Área de descanso	Área de descanso
Áreas de descanso	Área de descanso
area de descanso	Área de descanso
areas de descanso	Área de descanso
Arquitectura	Arquitectura
Atención a cliente	Atención a clientes
Atención a clientes	Atención a clientes
atencion a cliente	Atención a clientes
atencion a clientes	Atención a clientes
atension a cliente	Atención a clientes
Banco	Banco
Bancos	Banco
Baño	Baños
Baños	Baños
Cajero automático	Cajero automático
Cajeros automáticos	Cajero automático
cajero automatico	Cajero automático
cajeros automaticos	Cajero automático
Cajero de estacionamiento	Cajero de estacionamiento
Cajeros de estacionamiento	Cajero de estacionamiento
cajeros de estasionamiento	Cajero de estacionamiento
Centro de Atención a Clientes	Centro de Atención a Clientes
centro de atencion a clientes	Centro de Atención a Clientes
Centro de Atención Telefónica	Centro de Atención Telefónica
centro de atencion telefonica	Centro de Atención Telefónica
centro de atension telefonica	Centro de Atención Telefónica
Clima	Clima
Comercialización	Comercialización
comercializacion	Comercialización
comercializasion	Comercialización
Comida rápida	Comida rápida
comida rapida	Comida rápida
Directorios	Directorios
Diseño	Diseño
diseno	Diseño
Elevador	Elevadores
Elevadores	Elevadores
Entrada	Entradas
Entradas	Entradas
Entretenimiento	Entretenimiento
Escalera	Escaleras
Escaleras	Escaleras
Escalera eléctrica	Escalera eléctrica
escalera electrica	Escalera eléctrica
Escaleras eléctricas	Escalera eléctrica
escaleras electricas	Escalera eléctrica
Espacio	Espacio
Espacios	Espacio
Estacionamiento	Estacionamiento
estasionamiento	Estacionamiento
Estacionamientos	Estacionamiento
Evento	Evento
Eventos	Evento
Exhibición	Exhibición
exhibicion	Exhibición
Exhibiciones	Exhibición
Exposición	Exposición
exposicion	Exposición
Exposiciones	Exposición
exposisiones	Exposición
Fast food	Fast food
Food Court	Food Court
Galerías Club	Galerías Club
galerias club	Galerías Club
Galerías Magazine	Galerías Magazine
galerias magazine	Galerías Magazine
galerias magasine	Galerías Magazine
Galerías TV	Galerías TV
galerias tv	Galerías TV
Giro de tiendas	Giro de tiendas
Guardia	Guardia
Guardias	Guardia
Iluminación	Iluminación
iluminacion	Iluminación
iluminasion	Iluminación
Isla	Isla
Islas	Isla
Letrero	Letrero
Letreros	Letrero
Limpieza	Limpieza
limpiesa	Limpieza
Lugar para discapacitados	Lugar para discapacitados
Lugares para discapacitados	Lugar para discapacitados
Mal olor	Mal olor
mal holor	Mal olor
Mantenimiento	Mantenimiento
Máquinas de estacionamiento	Máquinas de estacionamiento
maquinas de estacionamiento	Máquinas de estacionamiento
maquinas de estasionamiento	Máquinas de estacionamiento
Mercadotecnia	Mercadotecnia
Módulo	Módulo
modulo	Módulo
Módulo de Atención y Servicio	Módulo de Atención y Servicio
modulo de atencion y servicio	Módulo de Atención y Servicio
modulo de atension y servisio	Módulo de Atención y Servicio
Módulo de Atención y Servicios	Módulo de Atención y Servicio
modulo de atencion y servicios	Módulo de Atención y Servicio
modulo de atension y servisios	Módulo de Atención y Servicio
Música	Música
musica	Música
Policía	Policía
policia	Policía
polisia	Policía
Policías	Policía
policias	Policía
polisias	Policía
Promociones	Promociones
promociones	Promociones
promosiones	Promociones
Publicidad	Publicidad
publisidad	Publicidad
Puerta automática	Puerta automática
puerta automatica	Puerta automática
Puertas automáticas	Puerta automática
puertas automaticas	Puerta automática
Rampa para discapacitados	Rampa para discapacitados
Rampas para discapacitados	Rampa para discapacitados
rampa de discapacitados	Rampa para discapacitados
Remodelación	Remodelación
remodelacion	Remodelación
remodelasion	Remodelación
Renta de espacio	Renta de espacio
Renta de espacios	Renta de espacio
Salida de emergencia	Salida de emergencia
Salidas de emergencia	Salida de emergencia
Seguridad	Seguridad
Señalamiento	Señalamiento
Señalamientos	Señalamiento
Señalización	Señalización
señalizacion	Señalización
señalizasion	Señalización
Servicio	Servicio
servisio	Servicio
Sitio de taxis	Sitio de taxis
Sonido ambiental	Sonido ambiental
Temperatura	Temperatura
Tráfico	Tráfico
trafico	Tráfico
Ubicación	Ubicación
ubicacion	Ubicación
ubicasion	Ubicación
Vendedor	Vendedor
Vendedora	Vendedora
Ventilación	Ventilación
ventilacion	Ventilación
ventilasion	Ventilación
Vía principal	Vía principal
via principal	Vía principal
Vías principales	Vía principal
vias principales	Vía principal
Zona de descanso	Zona de descanso
Zonas de descanso	Zona de descanso
sona de descanso	Zona de descanso
Zonas para niños	Zona para niños
sonas para niños	Zona para niños
Zona para niños	Zona para niños
sona para niños	Zona para niños
